userID,userSet,responseTimeSeconds,questionOrder,userResponse,questionID,correctResponse,chartType,questionSet,error,absDiff,correct,logError,distToHalfQuarter,distToHorizontalVertical,alignmentType,alignment
8,study7Pie,33.0,0,25,640,24,pie,set4,1,1,False,0.16992500144231237,1,9,non-aligned,non-aligned
8,study7Pie,46.0,1,20,641,17,pie,set3,3,3,False,1.6438561897747246,8,0,start0,aligned
8,study7Pie,34.0,2,40,642,28,pie,set1,12,12,False,3.599912842187128,3,0,start0,aligned
8,study7Pie,35.0,3,40,643,42,pie,set1,-2,2,False,1.0874628412503393,8,3,non-aligned,non-aligned
8,study7Pie,54.0,4,33,644,41,pie,set4,-8,8,False,3.0223678130284544,9,4,non-aligned,non-aligned
8,study7Pie,14.0,5,27,645,27,pie,set2,0,0,True,-3.0,2,0,start0,aligned
8,study7Pie,20.0,6,18,646,19,pie,set2,-1,1,False,0.16992500144231237,6,2,non-aligned,non-aligned
8,study7Pie,13.0,7,20,647,19,pie,set1,1,1,False,0.16992500144231237,6,0,start0,aligned
8,study7Pie,13.0,8,40,648,40,pie,set1,0,0,True,-3.0,10,6,non-aligned,non-aligned
8,study7Pie,16.0,9,48,649,49,pie,set2,-1,1,False,0.16992500144231237,1,0,start0,aligned
8,study7Pie,20.0,10,12,650,14,pie,set4,-2,2,False,1.0874628412503393,11,6,non-aligned,non-aligned
8,study7Pie,10.0,11,45,651,41,pie,set1,4,4,False,2.0443941193584534,9,0,start0,aligned
8,study7Pie,12.0,12,42,652,36,pie,set3,6,6,False,2.6147098441152083,11,3,non-aligned,non-aligned
8,study7Pie,9.0,13,10,653,11,pie,set2,-1,1,False,0.16992500144231237,11,0,start0,aligned
8,study7Pie,12.0,14,30,654,29,pie,set3,1,1,False,0.16992500144231237,4,9,non-aligned,non-aligned
8,study7Pie,11.0,15,25,655,26,pie,set2,-1,1,False,0.16992500144231237,1,10,non-aligned,non-aligned
8,study7Pie,14.0,16,22,656,25,pie,set3,-3,3,False,1.6438561897747246,0,5,non-aligned,non-aligned
8,study7Pie,11.0,17,42,657,43,pie,set2,-1,1,False,0.16992500144231237,7,0,start0,aligned
8,study7Pie,12.0,18,15,658,14,pie,set4,1,1,False,0.16992500144231237,11,0,start0,aligned
8,study7Pie,10.0,19,40,659,39,pie,set1,1,1,False,0.16992500144231237,11,4,non-aligned,non-aligned
8,study7Pie,11.0,20,12,660,13,pie,set1,-1,1,False,0.16992500144231237,12,6,non-aligned,non-aligned
8,study7Pie,8.0,21,12,661,12,pie,set4,0,0,True,-3.0,12,6,non-aligned,non-aligned
8,study7Pie,10.0,22,14,662,16,pie,set1,-2,2,False,1.0874628412503393,9,1,non-aligned,non-aligned
8,study7Pie,9.0,23,16,663,16,pie,set3,0,0,True,-3.0,9,0,start0,aligned
8,study7Pie,12.0,24,47,664,42,pie,set2,5,5,False,2.357552004618084,8,0,start0,aligned
8,study7Pie,10.0,25,15,665,13,pie,set2,2,2,False,1.0874628412503393,12,0,start0,aligned
8,study7Pie,9.0,26,40,666,38,pie,set1,2,2,False,1.0874628412503393,12,0,start0,aligned
8,study7Pie,11.0,27,11,667,11,pie,set2,0,0,True,-3.0,11,2,non-aligned,non-aligned
8,study7Pie,11.0,28,48,668,46,pie,set1,2,2,False,1.0874628412503393,4,0,start0,aligned
8,study7Pie,21.0,29,46,669,47,pie,set2,-1,1,False,0.16992500144231237,3,2,non-aligned,non-aligned
8,study7Pie,8.0,30,20,670,21,pie,set1,-1,1,False,0.16992500144231237,4,1,non-aligned,non-aligned
8,study7Pie,10.0,31,18,671,18,pie,set4,0,0,True,-3.0,7,3,non-aligned,non-aligned
8,study7Pie,12.0,32,49,672,47,pie,set2,2,2,False,1.0874628412503393,3,0,start0,aligned
8,study7Pie,10.0,33,50,673,50,pie,set4,0,0,True,-3.0,0,7,non-aligned,non-aligned
8,study7Pie,8.0,34,22,674,23,pie,set3,-1,1,False,0.16992500144231237,2,10,non-aligned,non-aligned
8,study7Pie,10.0,35,20,675,20,pie,set3,0,0,True,-3.0,5,0,start0,aligned
8,study7Pie,8.0,36,45,676,44,pie,set3,1,1,False,0.16992500144231237,6,0,start0,aligned
8,study7Pie,11.0,37,40,677,40,pie,set1,0,0,True,-3.0,10,0,start0,aligned
8,study7Pie,8.0,38,38,678,37,pie,set1,1,1,False,0.16992500144231237,12,0,start0,aligned
8,study7Pie,8.0,39,50,679,50,pie,set3,0,0,True,-3.0,0,0,start0,aligned
8,study7Pie,12.0,40,33,680,34,pie,set2,-1,1,False,0.16992500144231237,9,0,start0,aligned
8,study7Pie,8.0,41,18,681,18,pie,set3,0,0,True,-3.0,7,0,start0,aligned
8,study7Pie,10.0,42,15,682,15,pie,set1,0,0,True,-3.0,10,5,non-aligned,non-aligned
8,study7Pie,9.0,43,30,683,30,pie,set2,0,0,True,-3.0,5,0,start0,aligned
8,study7Pie,12.0,44,47,684,49,pie,set2,-2,2,False,1.0874628412503393,1,8,non-aligned,non-aligned
8,study7Pie,17.0,45,40,685,35,pie,set2,5,5,False,2.357552004618084,10,3,non-aligned,non-aligned
8,study7Pie,14.0,46,43,686,44,pie,set2,-1,1,False,0.16992500144231237,6,9,non-aligned,non-aligned
8,study7Pie,11.0,47,30,687,28,pie,set1,2,2,False,1.0874628412503393,3,10,non-aligned,non-aligned
8,study7Pie,15.0,48,42,688,37,pie,set2,5,5,False,2.357552004618084,12,5,non-aligned,non-aligned
8,study7Pie,8.0,49,33,689,38,pie,set4,-5,5,False,2.357552004618084,12,6,non-aligned,non-aligned
8,study7Pie,10.0,50,30,690,31,pie,set2,-1,1,False,0.16992500144231237,6,0,start0,aligned
8,study7Pie,10.0,51,45,691,45,pie,set1,0,0,True,-3.0,5,2,non-aligned,non-aligned
8,study7Pie,8.0,52,15,692,15,pie,set2,0,0,True,-3.0,10,0,start0,aligned
8,study7Pie,10.0,53,20,693,27,pie,set2,-7,7,False,2.8328900141647417,2,11,non-aligned,non-aligned
8,study7Pie,14.0,54,42,694,43,pie,set4,-1,1,False,0.16992500144231237,7,6,non-aligned,non-aligned
8,study7Pie,9.0,55,20,695,21,pie,set4,-1,1,False,0.16992500144231237,4,0,start0,aligned
8,study7Pie,12.0,56,42,696,46,pie,set1,-4,4,False,2.0443941193584534,4,6,non-aligned,non-aligned
8,study7Pie,8.0,57,40,697,39,pie,set3,1,1,False,0.16992500144231237,11,0,start0,aligned
8,study7Pie,14.0,58,33,698,34,pie,set2,-1,1,False,0.16992500144231237,9,2,non-aligned,non-aligned
8,study7Pie,10.0,59,28,699,32,pie,set4,-4,4,False,2.0443941193584534,7,7,non-aligned,non-aligned
8,study7Pie,8.0,60,49,700,48,pie,set2,1,1,False,0.16992500144231237,2,0,start0,aligned
8,study7Pie,9.0,61,25,701,25,pie,set3,0,0,True,-3.0,0,0,start0,aligned
8,study7Pie,7.0,62,33,702,36,pie,set2,-3,3,False,1.6438561897747246,11,0,start0,aligned
8,study7Pie,12.0,63,38,703,33,pie,set1,5,5,False,2.357552004618084,8,6,non-aligned,non-aligned
8,study7Pie,9.0,64,30,704,30,pie,set3,0,0,True,-3.0,5,7,non-aligned,non-aligned
8,study7Pie,11.0,65,24,705,23,pie,set1,1,1,False,0.16992500144231237,2,0,start0,aligned
8,study7Pie,10.0,66,33,706,35,pie,set4,-2,2,False,1.0874628412503393,10,0,start0,aligned
8,study7Pie,9.0,67,42,707,45,pie,set3,-3,3,False,1.6438561897747246,5,0,start0,aligned
8,study7Pie,9.0,68,20,708,20,pie,set1,0,0,True,-3.0,5,0,start75,aligned
8,study7Pie,0.0,69,20,709,22,pie,set1,-2,2,False,1.0874628412503393,3,0,start0,aligned
8,study7Pie,8.0,70,30,710,31,pie,set2,-1,1,False,0.16992500144231237,6,1,non-aligned,non-aligned
8,study7Pie,12.0,71,27,711,29,pie,set1,-2,2,False,1.0874628412503393,4,0,start0,aligned
8,study7Pie,8.0,72,25,712,26,pie,set3,-1,1,False,0.16992500144231237,1,0,start0,aligned
8,study7Pie,7.0,73,24,713,24,pie,set4,0,0,True,-3.0,1,0,start0,aligned
8,study7Pie,6.0,74,33,714,32,pie,set1,1,1,False,0.16992500144231237,7,0,start0,aligned
8,study7Pie,8.0,75,20,715,22,pie,set2,-2,2,False,1.0874628412503393,3,9,non-aligned,non-aligned
8,study7Pie,10.0,76,45,716,48,pie,set2,-3,3,False,1.6438561897747246,2,2,non-aligned,non-aligned
8,study7Pie,8.0,77,12,717,12,pie,set1,0,0,True,-3.0,12,0,start0,aligned
8,study7Pie,7.0,78,33,718,33,pie,set4,0,0,True,-3.0,8,0,start0,aligned
8,study7Pie,9.0,79,20,719,17,pie,set4,3,3,False,1.6438561897747246,8,1,non-aligned,non-aligned
32,study7Pie,12.0,0,35,2560,37,pie,set4,-2,2,False,1.0874628412503393,12,1,non-aligned,non-aligned
32,study7Pie,14.0,1,25,2561,35,pie,set4,-10,10,False,3.3398500028846247,10,0,start0,aligned
32,study7Pie,10.0,2,15,2562,17,pie,set4,-2,2,False,1.0874628412503393,8,0,start0,aligned
32,study7Pie,14.0,3,10,2563,12,pie,set2,-2,2,False,1.0874628412503393,12,1,non-aligned,non-aligned
32,study7Pie,7.0,4,20,2564,20,pie,set3,0,0,True,-3.0,5,2,non-aligned,non-aligned
32,study7Pie,8.0,5,45,2565,40,pie,set2,5,5,False,2.357552004618084,10,0,start0,aligned
32,study7Pie,9.0,6,25,2566,28,pie,set3,-3,3,False,1.6438561897747246,3,9,non-aligned,non-aligned
32,study7Pie,9.0,7,47,2567,43,pie,set1,4,4,False,2.0443941193584534,7,2,non-aligned,non-aligned
32,study7Pie,17.0,8,23,2568,23,pie,set2,0,0,True,-3.0,2,0,start0,aligned
32,study7Pie,7.0,9,20,2569,23,pie,set4,-3,3,False,1.6438561897747246,2,10,non-aligned,non-aligned
32,study7Pie,12.0,10,20,2570,17,pie,set1,3,3,False,1.6438561897747246,8,0,start25,aligned
32,study7Pie,9.0,11,25,2571,22,pie,set2,3,3,False,1.6438561897747246,3,0,start0,aligned
32,study7Pie,5.0,12,15,2572,16,pie,set4,-1,1,False,0.16992500144231237,9,0,start0,aligned
32,study7Pie,6.0,13,45,2573,39,pie,set3,6,6,False,2.6147098441152083,11,0,start0,aligned
32,study7Pie,6.0,14,40,2574,41,pie,set3,-1,1,False,0.16992500144231237,9,1,non-aligned,non-aligned
32,study7Pie,4.0,15,10,2575,11,pie,set4,-1,1,False,0.16992500144231237,11,0,start0,aligned
32,study7Pie,6.0,16,35,2576,33,pie,set2,2,2,False,1.0874628412503393,8,8,non-aligned,non-aligned
32,study7Pie,5.0,17,20,2577,15,pie,set2,5,5,False,2.357552004618084,10,0,start0,aligned
32,study7Pie,10.0,18,25,2578,21,pie,set4,4,4,False,2.0443941193584534,4,0,start0,aligned
32,study7Pie,7.0,19,48,2579,49,pie,set3,-1,1,False,0.16992500144231237,1,0,start0,aligned
32,study7Pie,4.0,20,10,2580,11,pie,set1,-1,1,False,0.16992500144231237,11,4,non-aligned,non-aligned
32,study7Pie,7.0,21,30,2581,27,pie,set2,3,3,False,1.6438561897747246,2,0,start0,aligned
32,study7Pie,7.0,22,30,2582,29,pie,set4,1,1,False,0.16992500144231237,4,3,non-aligned,non-aligned
32,study7Pie,13.0,23,40,2583,40,pie,set1,0,0,True,-3.0,10,6,non-aligned,non-aligned
32,study7Pie,10.0,24,40,2584,37,pie,set3,3,3,False,1.6438561897747246,12,0,start0,aligned
32,study7Pie,14.0,25,40,2585,36,pie,set4,4,4,False,2.0443941193584534,11,0,start0,aligned
32,study7Pie,8.0,26,30,2586,31,pie,set4,-1,1,False,0.16992500144231237,6,0,end50,aligned
32,study7Pie,5.0,27,25,2587,19,pie,set3,6,6,False,2.6147098441152083,6,1,non-aligned,non-aligned
32,study7Pie,6.0,28,30,2588,27,pie,set3,3,3,False,1.6438561897747246,2,6,non-aligned,non-aligned
32,study7Pie,11.0,29,25,2589,26,pie,set3,-1,1,False,0.16992500144231237,1,0,start0,aligned
32,study7Pie,7.0,30,30,2590,34,pie,set4,-4,4,False,2.0443941193584534,9,2,non-aligned,non-aligned
32,study7Pie,8.0,31,49,2591,49,pie,set3,0,0,True,-3.0,1,1,non-aligned,non-aligned
32,study7Pie,13.0,32,35,2592,32,pie,set2,3,3,False,1.6438561897747246,7,0,start0,aligned
32,study7Pie,8.0,33,40,2593,44,pie,set4,-4,4,False,2.0443941193584534,6,0,start0,aligned
32,study7Pie,9.0,34,15,2594,13,pie,set4,2,2,False,1.0874628412503393,12,6,non-aligned,non-aligned
32,study7Pie,6.0,35,48,2595,45,pie,set4,3,3,False,1.6438561897747246,5,0,start0,aligned
32,study7Pie,8.0,36,30,2596,29,pie,set4,1,1,False,0.16992500144231237,4,0,start0,aligned
32,study7Pie,14.0,37,38,2597,41,pie,set4,-3,3,False,1.6438561897747246,9,0,start0,aligned
32,study7Pie,8.0,38,15,2598,15,pie,set1,0,0,True,-3.0,10,5,non-aligned,non-aligned
32,study7Pie,7.0,39,48,2599,47,pie,set2,1,1,False,0.16992500144231237,3,2,non-aligned,non-aligned
32,study7Pie,8.0,40,20,2600,16,pie,set2,4,4,False,2.0443941193584534,9,2,non-aligned,non-aligned
32,study7Pie,8.0,41,20,2601,18,pie,set1,2,2,False,1.0874628412503393,7,0,start0,aligned
32,study7Pie,5.0,42,48,2602,46,pie,set2,2,2,False,1.0874628412503393,4,0,start0,aligned
32,study7Pie,6.0,43,47,2603,50,pie,set2,-3,3,False,1.6438561897747246,0,4,non-aligned,non-aligned
32,study7Pie,15.0,44,30,2604,22,pie,set1,8,8,False,3.0223678130284544,3,2,non-aligned,non-aligned
32,study7Pie,8.0,45,47,2605,44,pie,set4,3,3,False,1.6438561897747246,6,2,non-aligned,non-aligned
32,study7Pie,5.0,46,30,2606,28,pie,set4,2,2,False,1.0874628412503393,3,0,start0,aligned
32,study7Pie,6.0,47,30,2607,24,pie,set1,6,6,False,2.6147098441152083,1,5,non-aligned,non-aligned
32,study7Pie,9.0,48,35,2608,30,pie,set3,5,5,False,2.357552004618084,5,7,non-aligned,non-aligned
32,study7Pie,10.0,49,27,2609,24,pie,set1,3,3,False,1.6438561897747246,1,0,start0,aligned
32,study7Pie,7.0,50,27,2610,26,pie,set1,1,1,False,0.16992500144231237,1,3,non-aligned,non-aligned
32,study7Pie,5.0,51,20,2611,14,pie,set4,6,6,False,2.6147098441152083,11,0,start0,aligned
32,study7Pie,8.0,52,25,2612,25,pie,set3,0,0,True,-3.0,0,5,non-aligned,non-aligned
32,study7Pie,12.0,53,35,2613,43,pie,set3,-8,8,False,3.0223678130284544,7,0,start0,aligned
32,study7Pie,9.0,54,35,2614,38,pie,set1,-3,3,False,1.6438561897747246,12,0,start0,aligned
32,study7Pie,9.0,55,35,2615,36,pie,set1,-1,1,False,0.16992500144231237,11,3,non-aligned,non-aligned
32,study7Pie,8.0,56,43,2616,39,pie,set3,4,4,False,2.0443941193584534,11,3,non-aligned,non-aligned
32,study7Pie,6.0,57,25,2617,20,pie,set1,5,5,False,2.357552004618084,5,0,start0,aligned
32,study7Pie,8.0,58,40,2618,46,pie,set3,-6,6,False,2.6147098441152083,4,10,non-aligned,non-aligned
32,study7Pie,7.0,59,25,2619,19,pie,set2,6,6,False,2.6147098441152083,6,0,start0,aligned
32,study7Pie,11.0,60,25,2620,25,pie,set4,0,0,True,-3.0,0,0,start0,aligned
32,study7Pie,10.0,61,45,2621,45,pie,set4,0,0,True,-3.0,5,7,non-aligned,non-aligned
32,study7Pie,5.0,62,45,2622,47,pie,set2,-2,2,False,1.0874628412503393,3,0,start0,aligned
32,study7Pie,5.0,63,15,2623,13,pie,set3,2,2,False,1.0874628412503393,12,0,start0,aligned
32,study7Pie,22.0,64,37,2624,35,pie,set2,2,2,False,1.0874628412503393,10,3,non-aligned,non-aligned
32,study7Pie,7.0,65,47,2625,48,pie,set4,-1,1,False,0.16992500144231237,2,0,start0,aligned
32,study7Pie,4.0,66,30,2626,32,pie,set1,-2,2,False,1.0874628412503393,7,2,non-aligned,non-aligned
32,study7Pie,6.0,67,35,2627,38,pie,set3,-3,3,False,1.6438561897747246,12,3,non-aligned,non-aligned
32,study7Pie,5.0,68,20,2628,14,pie,set2,6,6,False,2.6147098441152083,11,4,non-aligned,non-aligned
32,study7Pie,17.0,69,38,2629,42,pie,set3,-4,4,False,2.0443941193584534,8,7,non-aligned,non-aligned
32,study7Pie,19.0,70,48,2630,50,pie,set2,-2,2,False,1.0874628412503393,0,0,start0,aligned
32,study7Pie,10.0,71,48,2631,48,pie,set1,0,0,True,-3.0,2,9,non-aligned,non-aligned
32,study7Pie,4.0,72,25,2632,21,pie,set2,4,4,False,2.0443941193584534,4,6,non-aligned,non-aligned
32,study7Pie,5.0,73,30,2633,33,pie,set3,-3,3,False,1.6438561897747246,8,0,start0,aligned
32,study7Pie,6.0,74,35,2634,34,pie,set1,1,1,False,0.16992500144231237,9,0,start0,aligned
32,study7Pie,6.0,75,20,2635,18,pie,set4,2,2,False,1.0874628412503393,7,3,non-aligned,non-aligned
32,study7Pie,6.0,76,15,2636,12,pie,set3,3,3,False,1.6438561897747246,12,0,start0,aligned
32,study7Pie,8.0,77,45,2637,42,pie,set2,3,3,False,1.6438561897747246,8,0,start0,aligned
32,study7Pie,8.0,78,35,2638,30,pie,set2,5,5,False,2.357552004618084,5,0,start0,aligned
32,study7Pie,8.0,79,35,2639,31,pie,set3,4,4,False,2.0443941193584534,6,0,start0,aligned
1,study7Pie,16.0,0,25,80,24,pie,set2,1,1,False,0.16992500144231237,1,0,start0,aligned
1,study7Pie,41.0,1,50,81,50,pie,set1,0,0,True,-3.0,0,6,non-aligned,non-aligned
1,study7Pie,16.0,2,15,82,14,pie,set1,1,1,False,0.16992500144231237,11,5,non-aligned,non-aligned
1,study7Pie,11.0,3,50,83,50,pie,set3,0,0,True,-3.0,0,0,start0,aligned
1,study7Pie,14.0,4,15,84,20,pie,set3,-5,5,False,2.357552004618084,5,2,non-aligned,non-aligned
1,study7Pie,37.0,5,30,85,29,pie,set1,1,1,False,0.16992500144231237,4,2,non-aligned,non-aligned
1,study7Pie,16.0,6,13,86,16,pie,set3,-3,3,False,1.6438561897747246,9,3,non-aligned,non-aligned
1,study7Pie,12.0,7,48,87,48,pie,set4,0,0,True,-3.0,2,0,start0,aligned
1,study7Pie,13.0,8,25,88,27,pie,set2,-2,2,False,1.0874628412503393,2,11,non-aligned,non-aligned
1,study7Pie,8.0,9,15,89,21,pie,set2,-6,6,False,2.6147098441152083,4,0,start0,aligned
1,study7Pie,14.0,10,30,90,37,pie,set4,-7,7,False,2.8328900141647417,12,1,non-aligned,non-aligned
1,study7Pie,39.0,11,10,91,12,pie,set3,-2,2,False,1.0874628412503393,12,0,start0,aligned
1,study7Pie,17.0,12,40,92,38,pie,set2,2,2,False,1.0874628412503393,12,5,non-aligned,non-aligned
1,study7Pie,10.0,13,45,93,36,pie,set4,9,9,False,3.189824558880017,11,3,non-aligned,non-aligned
1,study7Pie,9.0,14,25,94,28,pie,set4,-3,3,False,1.6438561897747246,3,5,non-aligned,non-aligned
1,study7Pie,10.0,15,20,95,29,pie,set3,-9,9,False,3.189824558880017,4,0,start0,aligned
1,study7Pie,16.0,16,35,96,38,pie,set1,-3,3,False,1.6438561897747246,12,0,start0,aligned
1,study7Pie,9.0,17,48,97,46,pie,set3,2,2,False,1.0874628412503393,4,0,start0,aligned
1,study7Pie,9.0,18,35,98,39,pie,set2,-4,4,False,2.0443941193584534,11,1,non-aligned,non-aligned
1,study7Pie,9.0,19,35,99,40,pie,set2,-5,5,False,2.357552004618084,10,1,non-aligned,non-aligned
1,study7Pie,8.0,20,45,100,43,pie,set2,2,2,False,1.0874628412503393,7,0,start0,aligned
1,study7Pie,9.0,21,10,101,13,pie,set4,-3,3,False,1.6438561897747246,12,6,non-aligned,non-aligned
1,study7Pie,7.0,22,15,102,15,pie,set2,0,0,True,-3.0,10,4,non-aligned,non-aligned
1,study7Pie,12.0,23,18,103,22,pie,set1,-4,4,False,2.0443941193584534,3,2,non-aligned,non-aligned
1,study7Pie,13.0,24,20,104,21,pie,set4,-1,1,False,0.16992500144231237,4,2,non-aligned,non-aligned
1,study7Pie,8.0,25,45,105,44,pie,set1,1,1,False,0.16992500144231237,6,0,start0,aligned
1,study7Pie,7.0,26,10,106,11,pie,set3,-1,1,False,0.16992500144231237,11,5,non-aligned,non-aligned
1,study7Pie,12.0,27,30,107,32,pie,set1,-2,2,False,1.0874628412503393,7,2,non-aligned,non-aligned
1,study7Pie,9.0,28,40,108,40,pie,set3,0,0,True,-3.0,10,0,start0,aligned
1,study7Pie,8.0,29,13,109,18,pie,set2,-5,5,False,2.357552004618084,7,1,non-aligned,non-aligned
1,study7Pie,10.0,30,20,110,31,pie,set4,-11,11,False,3.4757334309663976,6,0,end50,aligned
1,study7Pie,8.0,31,15,111,23,pie,set4,-8,8,False,3.0223678130284544,2,0,start0,aligned
1,study7Pie,19.0,32,47,112,43,pie,set3,4,4,False,2.0443941193584534,7,3,non-aligned,non-aligned
1,study7Pie,10.0,33,35,113,30,pie,set1,5,5,False,2.357552004618084,5,8,non-aligned,non-aligned
1,study7Pie,8.0,34,45,114,45,pie,set2,0,0,True,-3.0,5,0,start0,aligned
1,study7Pie,12.0,35,18,115,20,pie,set3,-2,2,False,1.0874628412503393,5,0,start0,aligned
1,study7Pie,8.0,36,18,116,22,pie,set3,-4,4,False,2.0443941193584534,3,0,start0,aligned
1,study7Pie,7.0,37,15,117,19,pie,set1,-4,4,False,2.0443941193584534,6,8,non-aligned,non-aligned
1,study7Pie,14.0,38,28,118,27,pie,set2,1,1,False,0.16992500144231237,2,0,start0,aligned
1,study7Pie,13.0,39,30,119,33,pie,set2,-3,3,False,1.6438561897747246,8,0,start0,aligned
1,study7Pie,10.0,40,48,120,46,pie,set3,2,2,False,1.0874628412503393,4,10,non-aligned,non-aligned
1,study7Pie,12.0,41,40,121,35,pie,set1,5,5,False,2.357552004618084,10,0,start0,aligned
1,study7Pie,9.0,42,35,122,30,pie,set3,5,5,False,2.357552004618084,5,0,start0,aligned
1,study7Pie,8.0,43,15,123,17,pie,set3,-2,2,False,1.0874628412503393,8,0,start0,aligned
1,study7Pie,13.0,44,35,124,42,pie,set3,-7,7,False,2.8328900141647417,8,0,start0,aligned
1,study7Pie,9.0,45,10,125,12,pie,set4,-2,2,False,1.0874628412503393,12,6,non-aligned,non-aligned
1,study7Pie,10.0,46,40,126,39,pie,set3,1,1,False,0.16992500144231237,11,0,start0,aligned
1,study7Pie,8.0,47,50,127,47,pie,set4,3,3,False,1.6438561897747246,3,0,start0,aligned
1,study7Pie,11.0,48,30,128,34,pie,set3,-4,4,False,2.0443941193584534,9,0,start0,aligned
1,study7Pie,8.0,49,10,129,13,pie,set1,-3,3,False,1.6438561897747246,12,0,start0,aligned
1,study7Pie,8.0,50,20,130,32,pie,set4,-12,12,False,3.599912842187128,7,0,start0,aligned
1,study7Pie,12.0,51,48,131,47,pie,set3,1,1,False,0.16992500144231237,3,10,non-aligned,non-aligned
1,study7Pie,11.0,52,25,132,25,pie,set2,0,0,True,-3.0,0,8,non-aligned,non-aligned
1,study7Pie,11.0,53,25,133,26,pie,set2,-1,1,False,0.16992500144231237,1,0,start0,aligned
1,study7Pie,10.0,54,30,134,34,pie,set3,-4,4,False,2.0443941193584534,9,3,non-aligned,non-aligned
1,study7Pie,11.0,55,35,135,41,pie,set2,-6,6,False,2.6147098441152083,9,0,start0,aligned
1,study7Pie,8.0,56,35,136,31,pie,set1,4,4,False,2.0443941193584534,6,0,start0,aligned
1,study7Pie,8.0,57,48,137,45,pie,set1,3,3,False,1.6438561897747246,5,2,non-aligned,non-aligned
1,study7Pie,7.0,58,10,138,11,pie,set4,-1,1,False,0.16992500144231237,11,0,start0,aligned
1,study7Pie,8.0,59,35,139,36,pie,set2,-1,1,False,0.16992500144231237,11,0,start0,aligned
1,study7Pie,22.0,60,48,140,44,pie,set1,4,4,False,2.0443941193584534,6,2,non-aligned,non-aligned
1,study7Pie,10.0,61,30,141,33,pie,set4,-3,3,False,1.6438561897747246,8,4,non-aligned,non-aligned
1,study7Pie,18.0,62,45,142,41,pie,set3,4,4,False,2.0443941193584534,9,1,non-aligned,non-aligned
1,study7Pie,7.0,63,15,143,16,pie,set2,-1,1,False,0.16992500144231237,9,0,start0,aligned
1,study7Pie,12.0,64,25,144,25,pie,set2,0,0,True,-3.0,0,0,start0,aligned
1,study7Pie,11.0,65,48,145,42,pie,set3,6,6,False,2.6147098441152083,8,7,non-aligned,non-aligned
1,study7Pie,13.0,66,23,146,26,pie,set4,-3,3,False,1.6438561897747246,1,1,non-aligned,non-aligned
1,study7Pie,8.0,67,48,147,48,pie,set2,0,0,True,-3.0,2,2,non-aligned,non-aligned
1,study7Pie,6.0,68,15,148,15,pie,set4,0,0,True,-3.0,10,0,start0,aligned
1,study7Pie,8.0,69,30,149,35,pie,set4,-5,5,False,2.357552004618084,10,0,end100,aligned
1,study7Pie,5.0,70,15,150,14,pie,set4,1,1,False,0.16992500144231237,11,0,start0,aligned
1,study7Pie,10.0,71,35,151,37,pie,set4,-2,2,False,1.0874628412503393,12,0,start0,aligned
1,study7Pie,7.0,72,16,152,17,pie,set3,-1,1,False,0.16992500144231237,8,3,non-aligned,non-aligned
1,study7Pie,12.0,73,20,153,24,pie,set1,-4,4,False,2.0443941193584534,1,5,non-aligned,non-aligned
1,study7Pie,10.0,74,23,154,23,pie,set1,0,0,True,-3.0,2,3,non-aligned,non-aligned
1,study7Pie,7.0,75,48,155,49,pie,set4,-1,1,False,0.16992500144231237,1,0,start0,aligned
1,study7Pie,13.0,76,18,156,18,pie,set3,0,0,True,-3.0,7,0,start0,aligned
1,study7Pie,9.0,77,20,157,19,pie,set3,1,1,False,0.16992500144231237,6,0,start0,aligned
1,study7Pie,12.0,78,28,158,28,pie,set1,0,0,True,-3.0,3,0,start0,aligned
1,study7Pie,8.0,79,48,159,49,pie,set3,-1,1,False,0.16992500144231237,1,1,non-aligned,non-aligned
27,study7Pie,31.0,0,48,2160,48,pie,set1,0,0,True,-3.0,2,9,non-aligned,non-aligned
27,study7Pie,27.0,1,50,2161,50,pie,set1,0,0,True,-3.0,0,6,non-aligned,non-aligned
27,study7Pie,13.0,2,33,2162,34,pie,set1,-1,1,False,0.16992500144231237,9,0,start0,aligned
27,study7Pie,31.0,3,18,2163,13,pie,set2,5,5,False,2.357552004618084,12,0,start0,aligned
27,study7Pie,18.0,4,30,2164,28,pie,set2,2,2,False,1.0874628412503393,3,8,non-aligned,non-aligned
27,study7Pie,18.0,5,45,2165,46,pie,set2,-1,1,False,0.16992500144231237,4,9,non-aligned,non-aligned
27,study7Pie,12.0,6,20,2166,24,pie,set1,-4,4,False,2.0443941193584534,1,0,start0,aligned
27,study7Pie,22.0,7,40,2167,38,pie,set3,2,2,False,1.0874628412503393,12,0,start0,aligned
27,study7Pie,10.0,8,15,2168,11,pie,set1,4,4,False,2.0443941193584534,11,0,start0,aligned
27,study7Pie,13.0,9,25,2169,27,pie,set2,-2,2,False,1.0874628412503393,2,11,non-aligned,non-aligned
27,study7Pie,29.0,10,12,2170,11,pie,set3,1,1,False,0.16992500144231237,11,5,non-aligned,non-aligned
27,study7Pie,53.0,11,23,2171,23,pie,set3,0,0,True,-3.0,2,0,start0,aligned
27,study7Pie,12.0,12,33,2172,36,pie,set3,-3,3,False,1.6438561897747246,11,3,non-aligned,non-aligned
27,study7Pie,13.0,13,28,2173,29,pie,set4,-1,1,False,0.16992500144231237,4,0,start0,aligned
27,study7Pie,15.0,14,25,2174,29,pie,set4,-4,4,False,2.0443941193584534,4,3,non-aligned,non-aligned
27,study7Pie,12.0,15,40,2175,40,pie,set2,0,0,True,-3.0,10,0,start0,aligned
27,study7Pie,11.0,16,18,2176,14,pie,set4,4,4,False,2.0443941193584534,11,6,non-aligned,non-aligned
27,study7Pie,6.0,17,33,2177,33,pie,set2,0,0,True,-3.0,8,8,non-aligned,non-aligned
27,study7Pie,10.0,18,15,2178,17,pie,set1,-2,2,False,1.0874628412503393,8,0,start25,aligned
27,study7Pie,93.0,19,30,2179,37,pie,set2,-7,7,False,2.8328900141647417,12,5,non-aligned,non-aligned
27,study7Pie,12.0,20,30,2180,18,pie,set1,12,12,False,3.599912842187128,7,1,non-aligned,non-aligned
27,study7Pie,16.0,21,40,2181,47,pie,set2,-7,7,False,2.8328900141647417,3,0,start0,aligned
27,study7Pie,13.0,22,30,2182,39,pie,set2,-9,9,False,3.189824558880017,11,1,non-aligned,non-aligned
27,study7Pie,5.0,23,15,2183,14,pie,set2,1,1,False,0.16992500144231237,11,0,start0,aligned
27,study7Pie,14.0,24,16,2184,16,pie,set3,0,0,True,-3.0,9,3,non-aligned,non-aligned
27,study7Pie,7.0,25,30,2185,38,pie,set4,-8,8,False,3.0223678130284544,12,6,non-aligned,non-aligned
27,study7Pie,10.0,26,20,2186,23,pie,set2,-3,3,False,1.6438561897747246,2,5,non-aligned,non-aligned
27,study7Pie,8.0,27,45,2187,44,pie,set2,1,1,False,0.16992500144231237,6,9,non-aligned,non-aligned
27,study7Pie,11.0,28,25,2188,30,pie,set3,-5,5,False,2.357552004618084,5,0,start0,aligned
27,study7Pie,9.0,29,42,2189,45,pie,set4,-3,3,False,1.6438561897747246,5,0,start0,aligned
27,study7Pie,5.0,30,15,2190,15,pie,set3,0,0,True,-3.0,10,0,start0,aligned
27,study7Pie,18.0,31,33,2191,31,pie,set2,2,2,False,1.0874628412503393,6,1,non-aligned,non-aligned
27,study7Pie,11.0,32,35,2192,36,pie,set4,-1,1,False,0.16992500144231237,11,0,start0,aligned
27,study7Pie,11.0,33,25,2193,24,pie,set4,1,1,False,0.16992500144231237,1,9,non-aligned,non-aligned
27,study7Pie,7.0,34,25,2194,26,pie,set4,-1,1,False,0.16992500144231237,1,0,start0,aligned
27,study7Pie,13.0,35,30,2195,34,pie,set3,-4,4,False,2.0443941193584534,9,3,non-aligned,non-aligned
27,study7Pie,7.0,36,48,2196,49,pie,set3,-1,1,False,0.16992500144231237,1,1,non-aligned,non-aligned
27,study7Pie,10.0,37,20,2197,19,pie,set2,1,1,False,0.16992500144231237,6,0,start0,aligned
27,study7Pie,7.0,38,33,2198,32,pie,set3,1,1,False,0.16992500144231237,7,0,start0,aligned
27,study7Pie,6.0,39,15,2199,19,pie,set3,-4,4,False,2.0443941193584534,6,1,non-aligned,non-aligned
27,study7Pie,8.0,40,40,2200,41,pie,set3,-1,1,False,0.16992500144231237,9,1,non-aligned,non-aligned
27,study7Pie,9.0,41,20,2201,20,pie,set1,0,0,True,-3.0,5,0,start0,aligned
27,study7Pie,13.0,42,45,2202,46,pie,set4,-1,1,False,0.16992500144231237,4,0,start0,aligned
27,study7Pie,11.0,43,18,2203,20,pie,set4,-2,2,False,1.0874628412503393,5,5,non-aligned,non-aligned
27,study7Pie,8.0,44,48,2204,47,pie,set4,1,1,False,0.16992500144231237,3,10,non-aligned,non-aligned
27,study7Pie,18.0,45,17,2205,18,pie,set3,-1,1,False,0.16992500144231237,7,0,start0,aligned
27,study7Pie,7.0,46,49,2206,49,pie,set4,0,0,True,-3.0,1,0,start0,aligned
27,study7Pie,7.0,47,45,2207,45,pie,set1,0,0,True,-3.0,5,2,non-aligned,non-aligned
27,study7Pie,7.0,48,30,2208,31,pie,set1,-1,1,False,0.16992500144231237,6,0,start0,aligned
27,study7Pie,7.0,49,40,2209,44,pie,set1,-4,4,False,2.0443941193584534,6,0,start0,aligned
27,study7Pie,13.0,50,40,2210,40,pie,set3,0,0,True,-3.0,10,2,non-aligned,non-aligned
27,study7Pie,7.0,51,45,2211,41,pie,set3,4,4,False,2.0443941193584534,9,0,start0,aligned
27,study7Pie,7.0,52,20,2212,22,pie,set2,-2,2,False,1.0874628412503393,3,0,start0,aligned
27,study7Pie,6.0,53,15,2213,13,pie,set2,2,2,False,1.0874628412503393,12,6,non-aligned,non-aligned
27,study7Pie,5.0,54,50,2214,50,pie,set4,0,0,True,-3.0,0,0,start0,aligned
27,study7Pie,14.0,55,18,2215,17,pie,set4,1,1,False,0.16992500144231237,8,0,start0,aligned
27,study7Pie,12.0,56,22,2216,22,pie,set2,0,0,True,-3.0,3,9,non-aligned,non-aligned
27,study7Pie,8.0,57,33,2217,35,pie,set4,-2,2,False,1.0874628412503393,10,0,start0,aligned
27,study7Pie,15.0,58,13,2218,12,pie,set3,1,1,False,0.16992500144231237,12,1,non-aligned,non-aligned
27,study7Pie,14.0,59,20,2219,15,pie,set2,5,5,False,2.357552004618084,10,4,non-aligned,non-aligned
27,study7Pie,6.0,60,15,2220,12,pie,set4,3,3,False,1.6438561897747246,12,0,start0,aligned
27,study7Pie,12.0,61,38,2221,42,pie,set4,-4,4,False,2.0443941193584534,8,1,non-aligned,non-aligned
27,study7Pie,7.0,62,15,2222,16,pie,set4,-1,1,False,0.16992500144231237,9,0,start0,aligned
27,study7Pie,12.0,63,28,2223,26,pie,set4,2,2,False,1.0874628412503393,1,1,non-aligned,non-aligned
27,study7Pie,8.0,64,25,2224,27,pie,set3,-2,2,False,1.0874628412503393,2,0,start0,aligned
27,study7Pie,8.0,65,35,2225,37,pie,set4,-2,2,False,1.0874628412503393,12,0,start0,aligned
27,study7Pie,9.0,66,30,2226,32,pie,set1,-2,2,False,1.0874628412503393,7,2,non-aligned,non-aligned
27,study7Pie,7.0,67,48,2227,48,pie,set3,0,0,True,-3.0,2,0,start0,aligned
27,study7Pie,12.0,68,35,2228,39,pie,set2,-4,4,False,2.0443941193584534,11,0,start0,aligned
27,study7Pie,8.0,69,27,2229,28,pie,set4,-1,1,False,0.16992500144231237,3,0,start0,aligned
27,study7Pie,8.0,70,22,2230,21,pie,set3,1,1,False,0.16992500144231237,4,0,start0,aligned
27,study7Pie,7.0,71,25,2231,25,pie,set1,0,0,True,-3.0,0,0,start0,aligned
27,study7Pie,7.0,72,45,2232,43,pie,set4,2,2,False,1.0874628412503393,7,6,non-aligned,non-aligned
27,study7Pie,9.0,73,36,2233,35,pie,set1,1,1,False,0.16992500144231237,10,6,non-aligned,non-aligned
27,study7Pie,6.0,74,42,2234,42,pie,set3,0,0,True,-3.0,8,0,start0,aligned
27,study7Pie,9.0,75,33,2235,33,pie,set1,0,0,True,-3.0,8,0,start0,aligned
27,study7Pie,8.0,76,23,2236,21,pie,set1,2,2,False,1.0874628412503393,4,1,non-aligned,non-aligned
27,study7Pie,5.0,77,30,2237,30,pie,set2,0,0,True,-3.0,5,4,non-aligned,non-aligned
27,study7Pie,11.0,78,25,2238,25,pie,set1,0,0,True,-3.0,0,7,non-aligned,non-aligned
27,study7Pie,6.0,79,40,2239,43,pie,set4,-3,3,False,1.6438561897747246,7,0,start0,aligned
15,study7Pie,12.0,0,20,1200,15,pie,set3,5,5,False,2.357552004618084,10,3,non-aligned,non-aligned
15,study7Pie,7.0,1,45,1201,43,pie,set1,2,2,False,1.0874628412503393,7,0,start0,aligned
15,study7Pie,11.0,2,20,1202,19,pie,set2,1,1,False,0.16992500144231237,6,0,start0,aligned
15,study7Pie,11.0,3,35,1203,35,pie,set2,0,0,True,-3.0,10,0,start0,aligned
15,study7Pie,12.0,4,43,1204,39,pie,set2,4,4,False,2.0443941193584534,11,1,non-aligned,non-aligned
15,study7Pie,8.0,5,35,1205,37,pie,set1,-2,2,False,1.0874628412503393,12,0,start0,aligned
15,study7Pie,7.0,6,22,1206,23,pie,set2,-1,1,False,0.16992500144231237,2,0,start0,aligned
15,study7Pie,6.0,7,24,1207,24,pie,set3,0,0,True,-3.0,1,0,start0,aligned
15,study7Pie,9.0,8,25,1208,24,pie,set3,1,1,False,0.16992500144231237,1,8,non-aligned,non-aligned
15,study7Pie,6.0,9,30,1209,29,pie,set2,1,1,False,0.16992500144231237,4,0,start0,aligned
15,study7Pie,10.0,10,12,1210,11,pie,set2,1,1,False,0.16992500144231237,11,0,start0,aligned
15,study7Pie,6.0,11,30,1211,31,pie,set1,-1,1,False,0.16992500144231237,6,4,non-aligned,non-aligned
15,study7Pie,9.0,12,38,1212,36,pie,set4,2,2,False,1.0874628412503393,11,0,start0,aligned
15,study7Pie,8.0,13,45,1213,46,pie,set4,-1,1,False,0.16992500144231237,4,0,start0,aligned
15,study7Pie,9.0,14,42,1214,44,pie,set2,-2,2,False,1.0874628412503393,6,9,non-aligned,non-aligned
15,study7Pie,11.0,15,18,1215,18,pie,set1,0,0,True,-3.0,7,1,non-aligned,non-aligned
15,study7Pie,9.0,16,15,1216,15,pie,set1,0,0,True,-3.0,10,0,start0,aligned
15,study7Pie,5.0,17,42,1217,47,pie,set2,-5,5,False,2.357552004618084,3,0,start0,aligned
15,study7Pie,7.0,18,45,1218,22,pie,set4,23,23,False,4.531381460516312,3,0,start75,aligned
15,study7Pie,7.0,19,33,1219,34,pie,set2,-1,1,False,0.16992500144231237,9,2,non-aligned,non-aligned
15,study7Pie,11.0,20,48,1220,50,pie,set4,-2,2,False,1.0874628412503393,0,0,start0,aligned
15,study7Pie,5.0,21,30,1221,30,pie,set2,0,0,True,-3.0,5,0,start0,aligned
15,study7Pie,8.0,22,28,1222,26,pie,set4,2,2,False,1.0874628412503393,1,0,start0,aligned
15,study7Pie,7.0,23,28,1223,29,pie,set4,-1,1,False,0.16992500144231237,4,3,non-aligned,non-aligned
15,study7Pie,6.0,24,48,1224,49,pie,set1,-1,1,False,0.16992500144231237,1,8,non-aligned,non-aligned
15,study7Pie,10.0,25,22,1225,14,pie,set2,8,8,False,3.0223678130284544,11,4,non-aligned,non-aligned
15,study7Pie,5.0,26,45,1226,43,pie,set3,2,2,False,1.0874628412503393,7,3,non-aligned,non-aligned
15,study7Pie,6.0,27,40,1227,40,pie,set2,0,0,True,-3.0,10,1,non-aligned,non-aligned
15,study7Pie,7.0,28,30,1228,27,pie,set3,3,3,False,1.6438561897747246,2,0,start0,aligned
15,study7Pie,5.0,29,38,1229,38,pie,set3,0,0,True,-3.0,12,0,start0,aligned
15,study7Pie,10.0,30,14,1230,16,pie,set2,-2,2,False,1.0874628412503393,9,0,start0,aligned
15,study7Pie,11.0,31,21,1231,22,pie,set2,-1,1,False,0.16992500144231237,3,0,start0,aligned
15,study7Pie,13.0,32,38,1232,37,pie,set4,1,1,False,0.16992500144231237,12,1,non-aligned,non-aligned
15,study7Pie,10.0,33,31,1233,30,pie,set1,1,1,False,0.16992500144231237,5,8,non-aligned,non-aligned
15,study7Pie,15.0,34,40,1234,39,pie,set2,1,1,False,0.16992500144231237,11,0,start0,aligned
15,study7Pie,6.0,35,23,1235,21,pie,set2,2,2,False,1.0874628412503393,4,6,non-aligned,non-aligned
15,study7Pie,6.0,36,45,1236,47,pie,set2,-2,2,False,1.0874628412503393,3,2,non-aligned,non-aligned
15,study7Pie,5.0,37,46,1237,49,pie,set4,-3,3,False,1.6438561897747246,1,0,start0,aligned
15,study7Pie,8.0,38,42,1238,42,pie,set3,0,0,True,-3.0,8,7,non-aligned,non-aligned
15,study7Pie,8.0,39,37,1239,35,pie,set3,2,2,False,1.0874628412503393,10,2,non-aligned,non-aligned
15,study7Pie,18.0,40,35,1240,33,pie,set4,2,2,False,1.0874628412503393,8,0,start0,aligned
15,study7Pie,17.0,41,40,1241,38,pie,set4,2,2,False,1.0874628412503393,12,6,non-aligned,non-aligned
15,study7Pie,9.0,42,11,1242,13,pie,set4,-2,2,False,1.0874628412503393,12,6,non-aligned,non-aligned
15,study7Pie,14.0,43,30,1243,32,pie,set3,-2,2,False,1.0874628412503393,7,2,non-aligned,non-aligned
15,study7Pie,12.0,44,31,1244,31,pie,set1,0,0,True,-3.0,6,0,start0,aligned
15,study7Pie,8.0,45,45,1245,46,pie,set3,-1,1,False,0.16992500144231237,4,10,non-aligned,non-aligned
15,study7Pie,5.0,46,45,1246,48,pie,set4,-3,3,False,1.6438561897747246,2,2,non-aligned,non-aligned
15,study7Pie,10.0,47,31,1247,34,pie,set3,-3,3,False,1.6438561897747246,9,0,start0,aligned
15,study7Pie,10.0,48,15,1248,14,pie,set4,1,1,False,0.16992500144231237,11,0,start0,aligned
15,study7Pie,10.0,49,38,1249,40,pie,set1,-2,2,False,1.0874628412503393,10,0,start0,aligned
15,study7Pie,8.0,50,18,1250,17,pie,set1,1,1,False,0.16992500144231237,8,0,start0,aligned
15,study7Pie,20.0,51,12,1251,13,pie,set3,-1,1,False,0.16992500144231237,12,0,start0,aligned
15,study7Pie,8.0,52,30,1252,28,pie,set1,2,2,False,1.0874628412503393,3,0,start0,aligned
15,study7Pie,10.0,53,21,1253,20,pie,set1,1,1,False,0.16992500144231237,5,0,start75,aligned
15,study7Pie,13.0,54,20,1254,19,pie,set4,1,1,False,0.16992500144231237,6,0,end75,aligned
15,study7Pie,7.0,55,27,1255,25,pie,set3,2,2,False,1.0874628412503393,0,0,start0,aligned
15,study7Pie,5.0,56,21,1256,20,pie,set3,1,1,False,0.16992500144231237,5,0,start0,aligned
15,study7Pie,10.0,57,22,1257,21,pie,set3,1,1,False,0.16992500144231237,4,0,start0,aligned
15,study7Pie,8.0,58,22,1258,25,pie,set3,-3,3,False,1.6438561897747246,0,5,non-aligned,non-aligned
15,study7Pie,10.0,59,11,1259,11,pie,set2,0,0,True,-3.0,11,2,non-aligned,non-aligned
15,study7Pie,6.0,60,32,1260,28,pie,set1,4,4,False,2.0443941193584534,3,10,non-aligned,non-aligned
15,study7Pie,6.0,61,45,1261,48,pie,set3,-3,3,False,1.6438561897747246,2,0,start0,aligned
15,study7Pie,6.0,62,47,1262,50,pie,set2,-3,3,False,1.6438561897747246,0,4,non-aligned,non-aligned
15,study7Pie,6.0,63,38,1263,33,pie,set4,5,5,False,2.357552004618084,8,4,non-aligned,non-aligned
15,study7Pie,9.0,64,38,1264,41,pie,set3,-3,3,False,1.6438561897747246,9,1,non-aligned,non-aligned
15,study7Pie,5.0,65,40,1265,44,pie,set1,-4,4,False,2.0443941193584534,6,0,start0,aligned
15,study7Pie,9.0,66,20,1266,16,pie,set2,4,4,False,2.0443941193584534,9,2,non-aligned,non-aligned
15,study7Pie,8.0,67,13,1267,12,pie,set1,1,1,False,0.16992500144231237,12,0,start0,aligned
15,study7Pie,6.0,68,23,1268,23,pie,set1,0,0,True,-3.0,2,3,non-aligned,non-aligned
15,study7Pie,8.0,69,38,1269,42,pie,set3,-4,4,False,2.0443941193584534,8,0,start0,aligned
15,study7Pie,10.0,70,38,1270,36,pie,set2,2,2,False,1.0874628412503393,11,1,non-aligned,non-aligned
15,study7Pie,5.0,71,12,1271,12,pie,set1,0,0,True,-3.0,12,1,non-aligned,non-aligned
15,study7Pie,6.0,72,40,1272,45,pie,set2,-5,5,False,2.357552004618084,5,9,non-aligned,non-aligned
15,study7Pie,8.0,73,24,1273,26,pie,set2,-2,2,False,1.0874628412503393,1,10,non-aligned,non-aligned
15,study7Pie,6.0,74,40,1274,45,pie,set2,-5,5,False,2.357552004618084,5,0,start0,aligned
15,study7Pie,9.0,75,20,1275,18,pie,set1,2,2,False,1.0874628412503393,7,0,start0,aligned
15,study7Pie,5.0,76,25,1276,27,pie,set2,-2,2,False,1.0874628412503393,2,11,non-aligned,non-aligned
15,study7Pie,6.0,77,32,1277,32,pie,set1,0,0,True,-3.0,7,0,start0,aligned
15,study7Pie,12.0,78,14,1278,17,pie,set2,-3,3,False,1.6438561897747246,8,5,non-aligned,non-aligned
15,study7Pie,7.0,79,40,1279,41,pie,set1,-1,1,False,0.16992500144231237,9,0,start0,aligned
22,study7Pie,19.0,0,40,1760,19,pie,set2,21,21,False,4.400879436282184,6,2,non-aligned,non-aligned
22,study7Pie,18.0,1,70,1761,45,pie,set3,25,25,False,4.651051691178929,5,0,start0,aligned
22,study7Pie,22.0,2,35,1762,29,pie,set4,6,6,False,2.6147098441152083,4,0,start0,aligned
22,study7Pie,19.0,3,65,1763,47,pie,set3,18,18,False,4.1799090900149345,3,10,non-aligned,non-aligned
22,study7Pie,27.0,4,45,1764,39,pie,set2,6,6,False,2.6147098441152083,11,0,start0,aligned
22,study7Pie,18.0,5,25,1765,12,pie,set3,13,13,False,3.7142455176661224,12,1,non-aligned,non-aligned
22,study7Pie,20.0,6,30,1766,32,pie,set2,-2,2,False,1.0874628412503393,7,0,start0,aligned
22,study7Pie,20.0,7,60,1767,49,pie,set2,11,11,False,3.4757334309663976,1,8,non-aligned,non-aligned
22,study7Pie,26.0,8,20,1768,21,pie,set1,-1,1,False,0.16992500144231237,4,1,non-aligned,non-aligned
22,study7Pie,19.0,9,50,1769,47,pie,set4,3,3,False,1.6438561897747246,3,0,start0,aligned
22,study7Pie,21.0,10,22,1770,20,pie,set4,2,2,False,1.0874628412503393,5,0,start0,aligned
22,study7Pie,25.0,11,40,1771,42,pie,set2,-2,2,False,1.0874628412503393,8,0,start0,aligned
22,study7Pie,49.0,12,30,1772,29,pie,set3,1,1,False,0.16992500144231237,4,9,non-aligned,non-aligned
22,study7Pie,23.0,13,14,1773,16,pie,set1,-2,2,False,1.0874628412503393,9,0,start0,aligned
22,study7Pie,16.0,14,20,1774,26,pie,set2,-6,6,False,2.6147098441152083,1,10,non-aligned,non-aligned
22,study7Pie,20.0,15,47,1775,46,pie,set2,1,1,False,0.16992500144231237,4,0,start0,aligned
22,study7Pie,23.0,16,62,1776,50,pie,set1,12,12,False,3.599912842187128,0,6,non-aligned,non-aligned
22,study7Pie,45.0,17,30,1777,33,pie,set2,-3,3,False,1.6438561897747246,8,8,non-aligned,non-aligned
22,study7Pie,24.0,18,30,1778,31,pie,set3,-1,1,False,0.16992500144231237,6,2,non-aligned,non-aligned
22,study7Pie,19.0,19,35,1779,33,pie,set1,2,2,False,1.0874628412503393,8,0,start0,aligned
22,study7Pie,37.0,20,32,1780,38,pie,set1,-6,6,False,2.6147098441152083,12,1,non-aligned,non-aligned
22,study7Pie,25.0,21,19,1781,17,pie,set4,2,2,False,1.0874628412503393,8,1,non-aligned,non-aligned
22,study7Pie,219.0,22,42,1782,37,pie,set3,5,5,False,2.357552004618084,12,0,start0,aligned
22,study7Pie,117.0,23,16,1783,14,pie,set2,2,2,False,1.0874628412503393,11,0,start0,aligned
22,study7Pie,19.0,24,46,1784,43,pie,set2,3,3,False,1.6438561897747246,7,2,non-aligned,non-aligned
22,study7Pie,19.0,25,13,1785,14,pie,set1,-1,1,False,0.16992500144231237,11,5,non-aligned,non-aligned
22,study7Pie,21.0,26,35,1786,36,pie,set1,-1,1,False,0.16992500144231237,11,0,start0,aligned
22,study7Pie,15.0,27,25,1787,22,pie,set4,3,3,False,1.6438561897747246,3,0,start75,aligned
22,study7Pie,22.0,28,20,1788,22,pie,set1,-2,2,False,1.0874628412503393,3,0,start0,aligned
22,study7Pie,34.0,29,50,1789,50,pie,set2,0,0,True,-3.0,0,0,start0,aligned
22,study7Pie,33.0,30,15,1790,17,pie,set1,-2,2,False,1.0874628412503393,8,0,start0,aligned
22,study7Pie,24.0,31,30,1791,40,pie,set3,-10,10,False,3.3398500028846247,10,0,start0,aligned
22,study7Pie,58.0,32,37,1792,38,pie,set2,-1,1,False,0.16992500144231237,12,0,start0,aligned
22,study7Pie,74.0,33,12,1793,13,pie,set4,-1,1,False,0.16992500144231237,12,6,non-aligned,non-aligned
22,study7Pie,15.0,34,25,1794,23,pie,set4,2,2,False,1.0874628412503393,2,0,start0,aligned
22,study7Pie,21.0,35,34,1795,28,pie,set3,6,6,False,2.6147098441152083,3,0,start0,aligned
22,study7Pie,40.0,36,36,1796,34,pie,set2,2,2,False,1.0874628412503393,9,2,non-aligned,non-aligned
22,study7Pie,260.0,37,29,1797,30,pie,set2,-1,1,False,0.16992500144231237,5,0,start0,aligned
22,study7Pie,17.0,38,32,1798,35,pie,set3,-3,3,False,1.6438561897747246,10,2,non-aligned,non-aligned
22,study7Pie,18.0,39,35,1799,37,pie,set3,-2,2,False,1.0874628412503393,12,0,start25,aligned
22,study7Pie,43.0,40,50,1800,44,pie,set3,6,6,False,2.6147098441152083,6,8,non-aligned,non-aligned
22,study7Pie,20.0,41,53,1801,48,pie,set3,5,5,False,2.357552004618084,2,0,start0,aligned
22,study7Pie,18.0,42,24,1802,19,pie,set3,5,5,False,2.357552004618084,6,0,start0,aligned
22,study7Pie,28.0,43,33,1803,28,pie,set4,5,5,False,2.357552004618084,3,5,non-aligned,non-aligned
22,study7Pie,24.0,44,35,1804,34,pie,set1,1,1,False,0.16992500144231237,9,0,start0,aligned
22,study7Pie,16.0,45,25,1805,15,pie,set1,10,10,False,3.3398500028846247,10,0,start0,aligned
22,study7Pie,68.0,46,42,1806,41,pie,set4,1,1,False,0.16992500144231237,9,4,non-aligned,non-aligned
22,study7Pie,62.0,47,28,1807,24,pie,set4,4,4,False,2.0443941193584534,1,0,start0,aligned
22,study7Pie,27.0,48,25,1808,26,pie,set4,-1,1,False,0.16992500144231237,1,0,start0,aligned
22,study7Pie,17.0,49,29,1809,30,pie,set4,-1,1,False,0.16992500144231237,5,1,non-aligned,non-aligned
22,study7Pie,19.0,50,40,1810,41,pie,set2,-1,1,False,0.16992500144231237,9,0,start0,aligned
22,study7Pie,38.0,51,34,1811,36,pie,set4,-2,2,False,1.0874628412503393,11,3,non-aligned,non-aligned
22,study7Pie,110.0,52,22,1812,16,pie,set2,6,6,False,2.6147098441152083,9,2,non-aligned,non-aligned
22,study7Pie,25.0,53,27,1813,27,pie,set2,0,0,True,-3.0,2,0,start0,aligned
22,study7Pie,26.0,55,35,1815,27,pie,set4,8,8,False,3.0223678130284544,2,3,non-aligned,non-aligned
22,study7Pie,22.0,56,24,1816,25,pie,set4,-1,1,False,0.16992500144231237,0,0,start0,aligned
22,study7Pie,43.0,57,40,1817,42,pie,set4,-2,2,False,1.0874628412503393,8,1,non-aligned,non-aligned
22,study7Pie,548.0,58,22,1818,18,pie,set1,4,4,False,2.0443941193584534,7,1,non-aligned,non-aligned
22,study7Pie,14.0,59,35,1819,31,pie,set2,4,4,False,2.0443941193584534,6,0,start0,aligned
22,study7Pie,21.0,60,45,1820,44,pie,set3,1,1,False,0.16992500144231237,6,0,start0,aligned
22,study7Pie,18.0,61,24,1821,18,pie,set4,6,6,False,2.6147098441152083,7,0,start0,aligned
22,study7Pie,17.0,62,15,1822,12,pie,set2,3,3,False,1.6438561897747246,12,0,start0,aligned
22,study7Pie,20.0,63,47,1823,39,pie,set1,8,8,False,3.0223678130284544,11,4,non-aligned,non-aligned
22,study7Pie,16.0,64,60,1824,48,pie,set1,12,12,False,3.599912842187128,2,9,non-aligned,non-aligned
22,study7Pie,16.0,65,24,1825,24,pie,set2,0,0,True,-3.0,1,2,non-aligned,non-aligned
22,study7Pie,14.0,66,32,1826,32,pie,set2,0,0,True,-3.0,7,6,non-aligned,non-aligned
22,study7Pie,94.0,67,60,1827,45,pie,set3,15,15,False,3.9188632372745946,5,7,non-aligned,non-aligned
22,study7Pie,236.0,68,20,1828,15,pie,set1,5,5,False,2.357552004618084,10,5,non-aligned,non-aligned
22,study7Pie,74.0,69,30,1829,20,pie,set1,10,10,False,3.3398500028846247,5,0,start75,aligned
22,study7Pie,111.0,70,36,1830,43,pie,set2,-7,7,False,2.8328900141647417,7,0,start0,aligned
22,study7Pie,52.0,71,20,1831,21,pie,set1,-1,1,False,0.16992500144231237,4,0,start0,aligned
22,study7Pie,14.0,72,25,1832,25,pie,set4,0,0,True,-3.0,0,0,start25,aligned
22,study7Pie,22.0,73,20,1833,13,pie,set2,7,7,False,2.8328900141647417,12,0,start0,aligned
22,study7Pie,14.0,74,12,1834,11,pie,set2,1,1,False,0.16992500144231237,11,0,start0,aligned
22,study7Pie,23.0,75,25,1835,35,pie,set3,-10,10,False,3.3398500028846247,10,0,start0,aligned
22,study7Pie,23.0,76,15,1836,11,pie,set4,4,4,False,2.0443941193584534,11,4,non-aligned,non-aligned
22,study7Pie,13.0,77,20,1837,23,pie,set1,-3,3,False,1.6438561897747246,2,3,non-aligned,non-aligned
22,study7Pie,12.0,78,30,1838,40,pie,set1,-10,10,False,3.3398500028846247,10,6,non-aligned,non-aligned
22,study7Pie,15.0,79,50,1839,49,pie,set1,1,1,False,0.16992500144231237,1,0,start0,aligned
22,study7Pie,23.0,54,65,1814,46,pie,set1,19,19,False,4.257387842692652,4,6,non-aligned,non-aligned
4,study7Pie,12.0,0,32,320,31,pie,set3,1,1,False,0.16992500144231237,6,2,non-aligned,non-aligned
4,study7Pie,6.0,1,45,321,45,pie,set1,0,0,True,-3.0,5,0,start0,aligned
4,study7Pie,13.0,2,31,322,32,pie,set4,-1,1,False,0.16992500144231237,7,0,start0,aligned
4,study7Pie,7.0,3,31,323,35,pie,set3,-4,4,False,2.0443941193584534,10,0,start0,aligned
4,study7Pie,6.0,4,15,324,15,pie,set2,0,0,True,-3.0,10,4,non-aligned,non-aligned
4,study7Pie,7.0,5,26,325,28,pie,set2,-2,2,False,1.0874628412503393,3,0,start0,aligned
4,study7Pie,6.0,6,47,326,48,pie,set1,-1,1,False,0.16992500144231237,2,0,start0,aligned
4,study7Pie,7.0,7,44,327,42,pie,set3,2,2,False,1.0874628412503393,8,7,non-aligned,non-aligned
4,study7Pie,6.0,8,11,328,16,pie,set1,-5,5,False,2.357552004618084,9,0,start0,aligned
4,study7Pie,7.0,9,20,329,22,pie,set2,-2,2,False,1.0874628412503393,3,0,start0,aligned
4,study7Pie,7.0,10,48,330,50,pie,set2,-2,2,False,1.0874628412503393,0,4,non-aligned,non-aligned
4,study7Pie,8.0,11,45,331,39,pie,set4,6,6,False,2.6147098441152083,11,1,non-aligned,non-aligned
4,study7Pie,9.0,12,22,332,21,pie,set1,1,1,False,0.16992500144231237,4,1,non-aligned,non-aligned
4,study7Pie,8.0,13,24,333,26,pie,set1,-2,2,False,1.0874628412503393,1,3,non-aligned,non-aligned
4,study7Pie,10.0,14,44,334,45,pie,set2,-1,1,False,0.16992500144231237,5,9,non-aligned,non-aligned
4,study7Pie,7.0,15,11,335,11,pie,set2,0,0,True,-3.0,11,2,non-aligned,non-aligned
4,study7Pie,6.0,16,40,336,43,pie,set1,-3,3,False,1.6438561897747246,7,2,non-aligned,non-aligned
4,study7Pie,7.0,17,23,337,23,pie,set4,0,0,True,-3.0,2,10,non-aligned,non-aligned
4,study7Pie,6.0,18,27,338,31,pie,set2,-4,4,False,2.0443941193584534,6,0,start0,aligned
4,study7Pie,6.0,19,15,339,15,pie,set4,0,0,True,-3.0,10,0,start0,aligned
4,study7Pie,6.0,20,27,340,29,pie,set1,-2,2,False,1.0874628412503393,4,0,start0,aligned
4,study7Pie,7.0,21,38,341,40,pie,set1,-2,2,False,1.0874628412503393,10,6,non-aligned,non-aligned
4,study7Pie,135.0,22,15,342,13,pie,set3,2,2,False,1.0874628412503393,12,2,non-aligned,non-aligned
4,study7Pie,9.0,23,22,343,22,pie,set4,0,0,True,-3.0,3,0,start75,aligned
4,study7Pie,6.0,24,28,344,33,pie,set2,-5,5,False,2.357552004618084,8,0,start0,aligned
4,study7Pie,5.0,25,24,345,25,pie,set1,-1,1,False,0.16992500144231237,0,0,start0,aligned
4,study7Pie,8.0,26,19,346,18,pie,set3,1,1,False,0.16992500144231237,7,0,start0,aligned
4,study7Pie,15.0,27,30,347,30,pie,set2,0,0,True,-3.0,5,4,non-aligned,non-aligned
4,study7Pie,5.0,28,30,348,28,pie,set3,2,2,False,1.0874628412503393,3,9,non-aligned,non-aligned
4,study7Pie,7.0,29,47,349,47,pie,set3,0,0,True,-3.0,3,0,start0,aligned
4,study7Pie,9.0,30,20,350,19,pie,set3,1,1,False,0.16992500144231237,6,1,non-aligned,non-aligned
4,study7Pie,5.0,31,20,351,20,pie,set1,0,0,True,-3.0,5,0,start75,aligned
4,study7Pie,6.0,32,33,352,37,pie,set4,-4,4,False,2.0443941193584534,12,1,non-aligned,non-aligned
4,study7Pie,4.0,33,47,353,46,pie,set2,1,1,False,0.16992500144231237,4,9,non-aligned,non-aligned
4,study7Pie,5.0,34,50,354,49,pie,set4,1,1,False,0.16992500144231237,1,0,start0,aligned
4,study7Pie,7.0,35,33,355,33,pie,set3,0,0,True,-3.0,8,3,non-aligned,non-aligned
4,study7Pie,15.0,36,38,356,38,pie,set1,0,0,True,-3.0,12,1,non-aligned,non-aligned
4,study7Pie,8.0,37,17,357,17,pie,set3,0,0,True,-3.0,8,0,start0,aligned
4,study7Pie,6.0,38,33,358,39,pie,set2,-6,6,False,2.6147098441152083,11,0,start0,aligned
4,study7Pie,9.0,39,9,359,12,pie,set3,-3,3,False,1.6438561897747246,12,0,start0,aligned
4,study7Pie,7.0,40,46,360,48,pie,set2,-2,2,False,1.0874628412503393,2,2,non-aligned,non-aligned
4,study7Pie,11.0,41,35,361,35,pie,set4,0,0,True,-3.0,10,0,end100,aligned
4,study7Pie,11.0,42,45,362,44,pie,set2,1,1,False,0.16992500144231237,6,0,start0,aligned
4,study7Pie,6.0,43,40,363,40,pie,set4,0,0,True,-3.0,10,0,start0,aligned
4,study7Pie,6.0,44,25,364,25,pie,set2,0,0,True,-3.0,0,8,non-aligned,non-aligned
4,study7Pie,4.0,45,26,365,27,pie,set2,-1,1,False,0.16992500144231237,2,0,start0,aligned
4,study7Pie,4.0,46,26,366,29,pie,set1,-3,3,False,1.6438561897747246,4,2,non-aligned,non-aligned
4,study7Pie,3.0,47,33,367,41,pie,set2,-8,8,False,3.0223678130284544,9,0,start0,aligned
4,study7Pie,4.0,48,20,368,21,pie,set4,-1,1,False,0.16992500144231237,4,0,start0,aligned
4,study7Pie,5.0,49,15,369,17,pie,set1,-2,2,False,1.0874628412503393,8,0,start25,aligned
4,study7Pie,7.0,50,33,370,34,pie,set4,-1,1,False,0.16992500144231237,9,2,non-aligned,non-aligned
4,study7Pie,6.0,51,15,371,18,pie,set4,-3,3,False,1.6438561897747246,7,3,non-aligned,non-aligned
4,study7Pie,5.0,52,50,372,49,pie,set1,1,1,False,0.16992500144231237,1,8,non-aligned,non-aligned
4,study7Pie,6.0,53,35,373,32,pie,set3,3,3,False,1.6438561897747246,7,2,non-aligned,non-aligned
4,study7Pie,4.0,54,40,374,46,pie,set1,-6,6,False,2.6147098441152083,4,0,start0,aligned
4,study7Pie,4.0,55,23,375,24,pie,set1,-1,1,False,0.16992500144231237,1,5,non-aligned,non-aligned
4,study7Pie,5.0,56,30,376,36,pie,set4,-6,6,False,2.6147098441152083,11,0,start0,aligned
4,study7Pie,7.0,57,29,377,37,pie,set4,-8,8,False,3.0223678130284544,12,0,start0,aligned
4,study7Pie,4.0,58,25,378,27,pie,set4,-2,2,False,1.0874628412503393,2,3,non-aligned,non-aligned
4,study7Pie,4.0,59,15,379,14,pie,set2,1,1,False,0.16992500144231237,11,0,start0,aligned
4,study7Pie,7.0,60,21,380,23,pie,set3,-2,2,False,1.0874628412503393,2,0,start0,aligned
4,study7Pie,8.0,61,33,381,38,pie,set1,-5,5,False,2.357552004618084,12,0,start0,aligned
4,study7Pie,5.0,62,24,382,24,pie,set4,0,0,True,-3.0,1,0,start0,aligned
4,study7Pie,12.0,63,40,383,42,pie,set4,-2,2,False,1.0874628412503393,8,0,start0,aligned
4,study7Pie,18.0,64,28,384,30,pie,set1,-2,2,False,1.0874628412503393,5,0,start0,aligned
4,study7Pie,7.0,65,40,385,41,pie,set3,-1,1,False,0.16992500144231237,9,1,non-aligned,non-aligned
4,study7Pie,15.0,66,40,386,44,pie,set3,-4,4,False,2.0443941193584534,6,8,non-aligned,non-aligned
4,study7Pie,41.0,67,33,387,34,pie,set4,-1,1,False,0.16992500144231237,9,0,start0,aligned
4,study7Pie,4.0,68,50,388,50,pie,set2,0,0,True,-3.0,0,0,start0,aligned
4,study7Pie,3.0,69,25,389,26,pie,set3,-1,1,False,0.16992500144231237,1,0,start0,aligned
4,study7Pie,4.0,70,10,390,11,pie,set2,-1,1,False,0.16992500144231237,11,0,start0,aligned
4,study7Pie,7.0,71,33,391,36,pie,set1,-3,3,False,1.6438561897747246,11,3,non-aligned,non-aligned
4,study7Pie,4.0,72,20,392,20,pie,set2,0,0,True,-3.0,5,0,start0,aligned
4,study7Pie,4.0,73,19,393,19,pie,set3,0,0,True,-3.0,6,0,start0,aligned
4,study7Pie,4.0,74,11,394,14,pie,set4,-3,3,False,1.6438561897747246,11,6,non-aligned,non-aligned
4,study7Pie,6.0,75,39,395,43,pie,set2,-4,4,False,2.0443941193584534,7,0,start0,aligned
4,study7Pie,4.0,76,15,396,16,pie,set1,-1,1,False,0.16992500144231237,9,1,non-aligned,non-aligned
4,study7Pie,4.0,77,10,397,12,pie,set2,-2,2,False,1.0874628412503393,12,1,non-aligned,non-aligned
4,study7Pie,4.0,78,40,398,47,pie,set1,-7,7,False,2.8328900141647417,3,2,non-aligned,non-aligned
4,study7Pie,4.0,79,15,399,13,pie,set3,2,2,False,1.0874628412503393,12,0,start0,aligned
10,study7Pie,15.0,0,35,800,22,pie,set4,13,13,False,3.7142455176661224,3,0,start0,aligned
10,study7Pie,12.0,1,40,801,43,pie,set2,-3,3,False,1.6438561897747246,7,0,start0,aligned
10,study7Pie,12.0,2,40,802,23,pie,set1,17,17,False,4.098032082960526,2,3,non-aligned,non-aligned
10,study7Pie,11.0,3,25,803,25,pie,set2,0,0,True,-3.0,0,0,start0,aligned
10,study7Pie,14.0,4,35,804,38,pie,set1,-3,3,False,1.6438561897747246,12,1,non-aligned,non-aligned
10,study7Pie,10.0,5,40,805,42,pie,set1,-2,2,False,1.0874628412503393,8,3,non-aligned,non-aligned
10,study7Pie,9.0,6,48,806,46,pie,set2,2,2,False,1.0874628412503393,4,0,start0,aligned
10,study7Pie,9.0,7,35,807,36,pie,set3,-1,1,False,0.16992500144231237,11,3,non-aligned,non-aligned
10,study7Pie,7.0,8,23,808,23,pie,set2,0,0,True,-3.0,2,0,start0,aligned
10,study7Pie,9.0,9,30,809,32,pie,set2,-2,2,False,1.0874628412503393,7,0,start0,aligned
10,study7Pie,8.0,10,40,810,45,pie,set2,-5,5,False,2.357552004618084,5,0,start0,aligned
10,study7Pie,5.0,11,25,811,22,pie,set3,3,3,False,1.6438561897747246,3,2,non-aligned,non-aligned
10,study7Pie,4.0,12,25,812,25,pie,set2,0,0,True,-3.0,0,8,non-aligned,non-aligned
10,study7Pie,5.0,13,35,813,31,pie,set2,4,4,False,2.0443941193584534,6,0,start0,aligned
10,study7Pie,12.0,14,12,814,11,pie,set4,1,1,False,0.16992500144231237,11,0,start0,aligned
10,study7Pie,8.0,15,15,815,13,pie,set2,2,2,False,1.0874628412503393,12,6,non-aligned,non-aligned
10,study7Pie,4.0,16,45,816,46,pie,set2,-1,1,False,0.16992500144231237,4,9,non-aligned,non-aligned
10,study7Pie,10.0,17,13,817,13,pie,set4,0,0,True,-3.0,12,0,start0,aligned
10,study7Pie,8.0,18,15,818,16,pie,set2,-1,1,False,0.16992500144231237,9,2,non-aligned,non-aligned
10,study7Pie,5.0,19,25,819,28,pie,set3,-3,3,False,1.6438561897747246,3,9,non-aligned,non-aligned
10,study7Pie,4.0,20,45,820,45,pie,set2,0,0,True,-3.0,5,9,non-aligned,non-aligned
10,study7Pie,6.0,21,48,821,49,pie,set3,-1,1,False,0.16992500144231237,1,1,non-aligned,non-aligned
10,study7Pie,6.0,22,30,822,27,pie,set3,3,3,False,1.6438561897747246,2,6,non-aligned,non-aligned
10,study7Pie,4.0,23,35,823,33,pie,set1,2,2,False,1.0874628412503393,8,6,non-aligned,non-aligned
10,study7Pie,4.0,24,25,824,24,pie,set3,1,1,False,0.16992500144231237,1,8,non-aligned,non-aligned
10,study7Pie,5.0,25,20,825,14,pie,set1,6,6,False,2.6147098441152083,11,5,non-aligned,non-aligned
10,study7Pie,6.0,26,49,826,49,pie,set1,0,0,True,-3.0,1,0,start0,aligned
10,study7Pie,5.0,27,30,827,31,pie,set1,-1,1,False,0.16992500144231237,6,4,non-aligned,non-aligned
10,study7Pie,6.0,28,35,828,37,pie,set3,-2,2,False,1.0874628412503393,12,0,start0,aligned
10,study7Pie,7.0,29,35,829,34,pie,set2,1,1,False,0.16992500144231237,9,2,non-aligned,non-aligned
10,study7Pie,5.0,30,40,830,40,pie,set4,0,0,True,-3.0,10,0,start0,aligned
10,study7Pie,4.0,31,50,831,50,pie,set4,0,0,True,-3.0,0,7,non-aligned,non-aligned
10,study7Pie,9.0,32,35,832,37,pie,set1,-2,2,False,1.0874628412503393,12,6,non-aligned,non-aligned
10,study7Pie,9.0,33,40,833,39,pie,set4,1,1,False,0.16992500144231237,11,1,non-aligned,non-aligned
10,study7Pie,6.0,34,35,834,35,pie,set1,0,0,True,-3.0,10,0,start0,aligned
10,study7Pie,6.0,35,24,835,24,pie,set4,0,0,True,-3.0,1,0,start0,aligned
10,study7Pie,8.0,36,35,836,38,pie,set2,-3,3,False,1.6438561897747246,12,0,start0,aligned
10,study7Pie,5.0,37,35,837,29,pie,set2,6,6,False,2.6147098441152083,4,2,non-aligned,non-aligned
10,study7Pie,7.0,38,40,838,39,pie,set1,1,1,False,0.16992500144231237,11,0,start0,aligned
10,study7Pie,9.0,39,18,839,14,pie,set4,4,4,False,2.0443941193584534,11,0,start0,aligned
10,study7Pie,5.0,40,40,840,41,pie,set2,-1,1,False,0.16992500144231237,9,4,non-aligned,non-aligned
10,study7Pie,5.0,41,20,841,20,pie,set1,0,0,True,-3.0,5,0,start75,aligned
10,study7Pie,5.0,42,30,842,34,pie,set2,-4,4,False,2.0443941193584534,9,0,start0,aligned
10,study7Pie,4.0,43,50,843,50,pie,set1,0,0,True,-3.0,0,0,start0,aligned
10,study7Pie,5.0,44,40,844,44,pie,set3,-4,4,False,2.0443941193584534,6,8,non-aligned,non-aligned
10,study7Pie,4.0,45,20,845,11,pie,set4,9,9,False,3.189824558880017,11,4,non-aligned,non-aligned
10,study7Pie,4.0,46,30,846,30,pie,set2,0,0,True,-3.0,5,4,non-aligned,non-aligned
10,study7Pie,5.0,47,15,847,12,pie,set3,3,3,False,1.6438561897747246,12,0,start0,aligned
10,study7Pie,9.0,48,20,848,21,pie,set1,-1,1,False,0.16992500144231237,4,0,start0,aligned
10,study7Pie,5.0,49,35,849,40,pie,set1,-5,5,False,2.357552004618084,10,6,non-aligned,non-aligned
10,study7Pie,5.0,50,40,850,43,pie,set4,-3,3,False,1.6438561897747246,7,6,non-aligned,non-aligned
10,study7Pie,6.0,51,20,851,19,pie,set1,1,1,False,0.16992500144231237,6,0,start0,aligned
10,study7Pie,4.0,52,18,852,12,pie,set2,6,6,False,2.6147098441152083,12,1,non-aligned,non-aligned
10,study7Pie,8.0,53,16,853,15,pie,set3,1,1,False,0.16992500144231237,10,0,start0,aligned
10,study7Pie,7.0,54,20,854,18,pie,set4,2,2,False,1.0874628412503393,7,0,start0,aligned
10,study7Pie,5.0,55,35,855,32,pie,set3,3,3,False,1.6438561897747246,7,2,non-aligned,non-aligned
10,study7Pie,5.0,56,40,856,42,pie,set1,-2,2,False,1.0874628412503393,8,0,start0,aligned
10,study7Pie,6.0,57,20,857,15,pie,set1,5,5,False,2.357552004618084,10,5,non-aligned,non-aligned
10,study7Pie,4.0,58,20,858,21,pie,set1,-1,1,False,0.16992500144231237,4,1,non-aligned,non-aligned
10,study7Pie,5.0,59,45,859,47,pie,set4,-2,2,False,1.0874628412503393,3,10,non-aligned,non-aligned
10,study7Pie,4.0,60,30,860,30,pie,set2,0,0,True,-3.0,5,0,start0,aligned
10,study7Pie,5.0,61,40,861,35,pie,set3,5,5,False,2.357552004618084,10,2,non-aligned,non-aligned
10,study7Pie,3.0,62,45,862,48,pie,set1,-3,3,False,1.6438561897747246,2,0,start0,aligned
10,study7Pie,4.0,63,30,863,29,pie,set3,1,1,False,0.16992500144231237,4,0,start0,aligned
10,study7Pie,4.0,64,35,864,33,pie,set2,2,2,False,1.0874628412503393,8,0,start0,aligned
10,study7Pie,4.0,65,38,865,36,pie,set2,2,2,False,1.0874628412503393,11,0,start0,aligned
10,study7Pie,4.0,66,45,866,48,pie,set3,-3,3,False,1.6438561897747246,2,2,non-aligned,non-aligned
10,study7Pie,4.0,67,20,867,20,pie,set1,0,0,True,-3.0,5,0,start0,aligned
10,study7Pie,5.0,68,30,868,27,pie,set3,3,3,False,1.6438561897747246,2,0,start0,aligned
10,study7Pie,4.0,69,20,869,16,pie,set4,4,4,False,2.0443941193584534,9,0,start0,aligned
10,study7Pie,4.0,70,30,870,28,pie,set2,2,2,False,1.0874628412503393,3,0,start0,aligned
10,study7Pie,4.0,71,40,871,41,pie,set1,-1,1,False,0.16992500144231237,9,0,start0,aligned
10,study7Pie,4.0,72,20,872,17,pie,set4,3,3,False,1.6438561897747246,8,0,start0,aligned
10,study7Pie,3.0,73,25,873,26,pie,set2,-1,1,False,0.16992500144231237,1,0,start0,aligned
10,study7Pie,4.0,74,40,874,44,pie,set1,-4,4,False,2.0443941193584534,6,0,start0,aligned
10,study7Pie,3.0,75,45,875,47,pie,set3,-2,2,False,1.0874628412503393,3,0,start0,aligned
10,study7Pie,4.0,76,20,876,19,pie,set3,1,1,False,0.16992500144231237,6,1,non-aligned,non-aligned
10,study7Pie,4.0,77,18,877,18,pie,set3,0,0,True,-3.0,7,2,non-aligned,non-aligned
10,study7Pie,5.0,78,18,878,17,pie,set1,1,1,False,0.16992500144231237,8,0,start25,aligned
10,study7Pie,5.0,79,30,879,26,pie,set1,4,4,False,2.0443941193584534,1,3,non-aligned,non-aligned
37,study7Pie,15.0,0,40,2960,37,pie,set2,3,3,False,1.6438561897747246,12,0,start0,aligned
37,study7Pie,26.0,1,35,2961,35,pie,set2,0,0,True,-3.0,10,0,start0,aligned
37,study7Pie,13.0,2,25,2962,25,pie,set1,0,0,True,-3.0,0,0,start0,aligned
37,study7Pie,10.0,3,45,2963,40,pie,set3,5,5,False,2.357552004618084,10,0,start0,aligned
37,study7Pie,6.0,4,50,2964,49,pie,set1,1,1,False,0.16992500144231237,1,0,start0,aligned
37,study7Pie,10.0,5,40,2965,34,pie,set1,6,6,False,2.6147098441152083,9,0,start0,aligned
37,study7Pie,7.0,6,30,2966,29,pie,set4,1,1,False,0.16992500144231237,4,0,start0,aligned
37,study7Pie,13.0,7,45,2967,38,pie,set1,7,7,False,2.8328900141647417,12,1,non-aligned,non-aligned
37,study7Pie,32.0,8,45,2968,43,pie,set1,2,2,False,1.0874628412503393,7,2,non-aligned,non-aligned
37,study7Pie,10.0,9,25,2969,26,pie,set4,-1,1,False,0.16992500144231237,1,0,start0,aligned
37,study7Pie,11.0,10,45,2970,34,pie,set2,11,11,False,3.4757334309663976,9,2,non-aligned,non-aligned
37,study7Pie,9.0,11,50,2971,50,pie,set1,0,0,True,-3.0,0,6,non-aligned,non-aligned
37,study7Pie,16.0,12,46,2972,46,pie,set1,0,0,True,-3.0,4,6,non-aligned,non-aligned
37,study7Pie,10.0,13,30,2973,32,pie,set4,-2,2,False,1.0874628412503393,7,7,non-aligned,non-aligned
37,study7Pie,135.0,14,30,2974,30,pie,set1,0,0,True,-3.0,5,0,start0,aligned
37,study7Pie,12.0,15,48,2975,48,pie,set4,0,0,True,-3.0,2,0,start0,aligned
37,study7Pie,12.0,16,15,2976,15,pie,set3,0,0,True,-3.0,10,3,non-aligned,non-aligned
37,study7Pie,37.0,17,48,2977,48,pie,set1,0,0,True,-3.0,2,9,non-aligned,non-aligned
37,study7Pie,17.0,18,46,2978,39,pie,set2,7,7,False,2.8328900141647417,11,0,start0,aligned
37,study7Pie,14.0,19,20,2979,18,pie,set4,2,2,False,1.0874628412503393,7,3,non-aligned,non-aligned
37,study7Pie,10.0,20,45,2980,42,pie,set2,3,3,False,1.6438561897747246,8,0,start0,aligned
37,study7Pie,9.0,21,30,2981,27,pie,set3,3,3,False,1.6438561897747246,2,0,start0,aligned
37,study7Pie,11.0,22,35,2982,33,pie,set3,2,2,False,1.0874628412503393,8,3,non-aligned,non-aligned
37,study7Pie,11.0,23,20,2983,24,pie,set1,-4,4,False,2.0443941193584534,1,5,non-aligned,non-aligned
37,study7Pie,9.0,24,15,2984,13,pie,set4,2,2,False,1.0874628412503393,12,6,non-aligned,non-aligned
37,study7Pie,13.0,25,45,2985,44,pie,set4,1,1,False,0.16992500144231237,6,2,non-aligned,non-aligned
37,study7Pie,5.0,26,20,2986,29,pie,set1,-9,9,False,3.189824558880017,4,2,non-aligned,non-aligned
37,study7Pie,9.0,27,40,2987,39,pie,set4,1,1,False,0.16992500144231237,11,1,non-aligned,non-aligned
37,study7Pie,6.0,28,45,2988,47,pie,set4,-2,2,False,1.0874628412503393,3,0,start0,aligned
37,study7Pie,10.0,29,25,2989,27,pie,set3,-2,2,False,1.0874628412503393,2,6,non-aligned,non-aligned
37,study7Pie,8.0,30,20,2990,12,pie,set2,8,8,False,3.0223678130284544,12,0,start0,aligned
37,study7Pie,23.0,31,35,2991,35,pie,set1,0,0,True,-3.0,10,6,non-aligned,non-aligned
37,study7Pie,14.0,32,45,2992,42,pie,set1,3,3,False,1.6438561897747246,8,3,non-aligned,non-aligned
37,study7Pie,13.0,33,25,2993,20,pie,set4,5,5,False,2.357552004618084,5,5,non-aligned,non-aligned
37,study7Pie,54.0,34,25,2994,13,pie,set4,12,12,False,3.599912842187128,12,0,start0,aligned
37,study7Pie,12.0,35,35,2995,37,pie,set1,-2,2,False,1.0874628412503393,12,6,non-aligned,non-aligned
37,study7Pie,10.0,36,45,2996,36,pie,set3,9,9,False,3.189824558880017,11,3,non-aligned,non-aligned
37,study7Pie,82.0,37,45,2997,45,pie,set3,0,0,True,-3.0,5,0,start0,aligned
37,study7Pie,5.0,38,25,2998,16,pie,set1,9,9,False,3.189824558880017,9,1,non-aligned,non-aligned
37,study7Pie,6.0,39,45,2999,45,pie,set3,0,0,True,-3.0,5,7,non-aligned,non-aligned
37,study7Pie,5.0,40,25,3000,20,pie,set2,5,5,False,2.357552004618084,5,0,start0,aligned
37,study7Pie,6.0,41,45,3001,47,pie,set1,-2,2,False,1.0874628412503393,3,2,non-aligned,non-aligned
37,study7Pie,8.0,42,30,3002,24,pie,set3,6,6,False,2.6147098441152083,1,0,start0,aligned
37,study7Pie,6.0,43,20,3003,11,pie,set1,9,9,False,3.189824558880017,11,4,non-aligned,non-aligned
37,study7Pie,8.0,44,40,3004,40,pie,set2,0,0,True,-3.0,10,1,non-aligned,non-aligned
37,study7Pie,4.0,45,45,3005,43,pie,set4,2,2,False,1.0874628412503393,7,0,start0,aligned
37,study7Pie,5.0,46,25,3006,21,pie,set2,4,4,False,2.0443941193584534,4,6,non-aligned,non-aligned
37,study7Pie,8.0,47,25,3007,17,pie,set3,8,8,False,3.0223678130284544,8,0,start0,aligned
37,study7Pie,5.0,48,25,3008,16,pie,set2,9,9,False,3.189824558880017,9,0,start0,aligned
37,study7Pie,4.0,49,30,3009,23,pie,set1,7,7,False,2.8328900141647417,2,0,start0,aligned
37,study7Pie,9.0,50,40,3010,36,pie,set2,4,4,False,2.0443941193584534,11,0,start0,aligned
37,study7Pie,47.0,51,25,3011,19,pie,set1,6,6,False,2.6147098441152083,6,8,non-aligned,non-aligned
37,study7Pie,15.0,52,25,3012,15,pie,set1,10,10,False,3.3398500028846247,10,0,start0,aligned
37,study7Pie,27.0,53,35,3013,28,pie,set3,7,7,False,2.8328900141647417,3,9,non-aligned,non-aligned
37,study7Pie,12.0,54,48,3014,46,pie,set2,2,2,False,1.0874628412503393,4,0,start0,aligned
37,study7Pie,8.0,55,48,3015,49,pie,set4,-1,1,False,0.16992500144231237,1,5,non-aligned,non-aligned
37,study7Pie,11.0,56,15,3016,12,pie,set4,3,3,False,1.6438561897747246,12,6,non-aligned,non-aligned
37,study7Pie,7.0,57,30,3017,31,pie,set3,-1,1,False,0.16992500144231237,6,2,non-aligned,non-aligned
37,study7Pie,5.0,58,15,3018,14,pie,set2,1,1,False,0.16992500144231237,11,0,start0,aligned
37,study7Pie,7.0,59,25,3019,17,pie,set1,8,8,False,3.0223678130284544,8,0,start25,aligned
37,study7Pie,12.0,60,15,3020,14,pie,set3,1,1,False,0.16992500144231237,11,2,non-aligned,non-aligned
37,study7Pie,6.0,61,25,3021,26,pie,set1,-1,1,False,0.16992500144231237,1,3,non-aligned,non-aligned
37,study7Pie,5.0,62,30,3022,41,pie,set4,-11,11,False,3.4757334309663976,9,0,start0,aligned
37,study7Pie,9.0,63,25,3023,21,pie,set4,4,4,False,2.0443941193584534,4,0,start0,aligned
37,study7Pie,7.0,64,25,3024,23,pie,set1,2,2,False,1.0874628412503393,2,3,non-aligned,non-aligned
37,study7Pie,6.0,65,50,3025,50,pie,set3,0,0,True,-3.0,0,0,start0,aligned
37,study7Pie,55.0,66,30,3026,28,pie,set1,2,2,False,1.0874628412503393,3,0,start0,aligned
37,study7Pie,4.0,67,25,3027,22,pie,set2,3,3,False,1.6438561897747246,3,9,non-aligned,non-aligned
37,study7Pie,7.0,68,25,3028,22,pie,set1,3,3,False,1.6438561897747246,3,0,start0,aligned
37,study7Pie,5.0,69,15,3029,11,pie,set3,4,4,False,2.0443941193584534,11,0,start0,aligned
37,study7Pie,7.0,70,45,3030,44,pie,set3,1,1,False,0.16992500144231237,6,0,start0,aligned
37,study7Pie,5.0,71,20,3031,19,pie,set2,1,1,False,0.16992500144231237,6,0,start0,aligned
37,study7Pie,6.0,72,30,3032,30,pie,set1,0,0,True,-3.0,5,8,non-aligned,non-aligned
37,study7Pie,11.0,73,25,3033,25,pie,set4,0,0,True,-3.0,0,0,start25,aligned
37,study7Pie,6.0,74,30,3034,31,pie,set1,-1,1,False,0.16992500144231237,6,0,start0,aligned
37,study7Pie,27.0,75,40,3035,33,pie,set4,7,7,False,2.8328900141647417,8,0,start0,aligned
37,study7Pie,7.0,76,30,3036,32,pie,set1,-2,2,False,1.0874628412503393,7,0,start0,aligned
37,study7Pie,14.0,77,45,3037,41,pie,set4,4,4,False,2.0443941193584534,9,4,non-aligned,non-aligned
37,study7Pie,7.0,78,40,3038,38,pie,set1,2,2,False,1.0874628412503393,12,0,start0,aligned
37,study7Pie,8.0,79,20,3039,18,pie,set4,2,2,False,1.0874628412503393,7,0,start0,aligned
19,study7Pie,7.0,0,22,1520,28,pie,set1,-6,6,False,2.6147098441152083,3,10,non-aligned,non-aligned
19,study7Pie,7.0,1,23,1521,25,pie,set1,-2,2,False,1.0874628412503393,0,0,start0,aligned
19,study7Pie,6.0,2,45,1522,41,pie,set1,4,4,False,2.0443941193584534,9,6,non-aligned,non-aligned
19,study7Pie,6.0,3,38,1523,36,pie,set1,2,2,False,1.0874628412503393,11,0,start0,aligned
19,study7Pie,7.0,4,41,1524,40,pie,set1,1,1,False,0.16992500144231237,10,0,start0,aligned
19,study7Pie,5.0,5,11,1525,13,pie,set3,-2,2,False,1.0874628412503393,12,2,non-aligned,non-aligned
19,study7Pie,7.0,6,20,1526,24,pie,set3,-4,4,False,2.0443941193584534,1,0,start0,aligned
19,study7Pie,5.0,7,33,1527,37,pie,set2,-4,4,False,2.0443941193584534,12,5,non-aligned,non-aligned
19,study7Pie,8.0,8,31,1528,39,pie,set3,-8,8,False,3.0223678130284544,11,3,non-aligned,non-aligned
19,study7Pie,5.0,9,47,1529,47,pie,set1,0,0,True,-3.0,3,0,start0,aligned
19,study7Pie,7.0,10,19,1530,22,pie,set4,-3,3,False,1.6438561897747246,3,0,start0,aligned
19,study7Pie,5.0,11,48,1531,49,pie,set2,-1,1,False,0.16992500144231237,1,0,start0,aligned
19,study7Pie,4.0,12,39,1532,35,pie,set2,4,4,False,2.0443941193584534,10,0,start0,aligned
19,study7Pie,8.0,13,43,1533,40,pie,set3,3,3,False,1.6438561897747246,10,2,non-aligned,non-aligned
19,study7Pie,4.0,14,48,1534,48,pie,set2,0,0,True,-3.0,2,0,start0,aligned
19,study7Pie,4.0,15,14,1535,17,pie,set2,-3,3,False,1.6438561897747246,8,5,non-aligned,non-aligned
19,study7Pie,6.0,16,16,1536,19,pie,set1,-3,3,False,1.6438561897747246,6,8,non-aligned,non-aligned
19,study7Pie,3.0,17,11,1537,13,pie,set1,-2,2,False,1.0874628412503393,12,0,start0,aligned
19,study7Pie,3.0,18,10,1538,12,pie,set2,-2,2,False,1.0874628412503393,12,1,non-aligned,non-aligned
19,study7Pie,5.0,19,36,1539,38,pie,set4,-2,2,False,1.0874628412503393,12,6,non-aligned,non-aligned
19,study7Pie,5.0,20,37,1540,32,pie,set2,5,5,False,2.357552004618084,7,0,start0,aligned
19,study7Pie,4.0,21,39,1541,38,pie,set4,1,1,False,0.16992500144231237,12,0,start0,aligned
19,study7Pie,6.0,22,25,1542,30,pie,set1,-5,5,False,2.357552004618084,5,8,non-aligned,non-aligned
19,study7Pie,4.0,23,10,1543,12,pie,set1,-2,2,False,1.0874628412503393,12,0,start0,aligned
19,study7Pie,4.0,24,43,1544,43,pie,set3,0,0,True,-3.0,7,0,start0,aligned
19,study7Pie,4.0,25,26,1545,25,pie,set4,1,1,False,0.16992500144231237,0,0,start25,aligned
19,study7Pie,3.0,26,13,1546,16,pie,set2,-3,3,False,1.6438561897747246,9,0,start0,aligned
19,study7Pie,5.0,27,27,1547,26,pie,set3,1,1,False,0.16992500144231237,1,3,non-aligned,non-aligned
19,study7Pie,4.0,28,12,1548,14,pie,set2,-2,2,False,1.0874628412503393,11,0,start0,aligned
19,study7Pie,4.0,29,48,1549,48,pie,set3,0,0,True,-3.0,2,2,non-aligned,non-aligned
19,study7Pie,8.0,30,24,1550,29,pie,set2,-5,5,False,2.357552004618084,4,2,non-aligned,non-aligned
19,study7Pie,5.0,31,20,1551,21,pie,set1,-1,1,False,0.16992500144231237,4,0,start0,aligned
19,study7Pie,6.0,32,17,1552,19,pie,set3,-2,2,False,1.0874628412503393,6,0,start0,aligned
19,study7Pie,7.0,33,26,1553,30,pie,set1,-4,4,False,2.0443941193584534,5,0,start0,aligned
19,study7Pie,4.0,34,22,1554,23,pie,set1,-1,1,False,0.16992500144231237,2,0,start0,aligned
19,study7Pie,4.0,35,38,1555,34,pie,set4,4,4,False,2.0443941193584534,9,0,start0,aligned
19,study7Pie,6.0,36,43,1556,44,pie,set4,-1,1,False,0.16992500144231237,6,2,non-aligned,non-aligned
19,study7Pie,7.0,37,20,1557,20,pie,set1,0,0,True,-3.0,5,0,start75,aligned
19,study7Pie,5.0,38,42,1558,39,pie,set3,3,3,False,1.6438561897747246,11,0,start0,aligned
19,study7Pie,4.0,39,25,1559,26,pie,set4,-1,1,False,0.16992500144231237,1,0,start0,aligned
19,study7Pie,8.0,40,41,1560,42,pie,set3,-1,1,False,0.16992500144231237,8,7,non-aligned,non-aligned
19,study7Pie,3.0,41,47,1561,45,pie,set4,2,2,False,1.0874628412503393,5,0,start0,aligned
19,study7Pie,5.0,42,23,1562,24,pie,set4,-1,1,False,0.16992500144231237,1,9,non-aligned,non-aligned
19,study7Pie,5.0,43,39,1563,37,pie,set3,2,2,False,1.0874628412503393,12,0,start0,aligned
19,study7Pie,5.0,44,16,1564,16,pie,set1,0,0,True,-3.0,9,1,non-aligned,non-aligned
19,study7Pie,3.0,45,18,1565,18,pie,set4,0,0,True,-3.0,7,3,non-aligned,non-aligned
19,study7Pie,4.0,46,27,1566,32,pie,set1,-5,5,False,2.357552004618084,7,2,non-aligned,non-aligned
19,study7Pie,5.0,47,26,1567,29,pie,set3,-3,3,False,1.6438561897747246,4,0,start0,aligned
19,study7Pie,5.0,48,25,1568,28,pie,set3,-3,3,False,1.6438561897747246,3,0,start0,aligned
19,study7Pie,4.0,49,31,1569,36,pie,set1,-5,5,False,2.357552004618084,11,3,non-aligned,non-aligned
19,study7Pie,4.0,50,17,1570,17,pie,set2,0,0,True,-3.0,8,0,start0,aligned
19,study7Pie,4.0,51,42,1571,44,pie,set1,-2,2,False,1.0874628412503393,6,0,start0,aligned
19,study7Pie,6.0,52,22,1572,22,pie,set3,0,0,True,-3.0,3,2,non-aligned,non-aligned
19,study7Pie,5.0,53,32,1573,33,pie,set2,-1,1,False,0.16992500144231237,8,8,non-aligned,non-aligned
19,study7Pie,4.0,54,19,1574,20,pie,set4,-1,1,False,0.16992500144231237,5,0,start0,aligned
19,study7Pie,8.0,55,14,1575,14,pie,set4,0,0,True,-3.0,11,6,non-aligned,non-aligned
19,study7Pie,4.0,56,44,1576,46,pie,set3,-2,2,False,1.0874628412503393,4,0,start0,aligned
19,study7Pie,7.0,57,9,1577,11,pie,set1,-2,2,False,1.0874628412503393,11,4,non-aligned,non-aligned
19,study7Pie,5.0,58,48,1578,49,pie,set3,-1,1,False,0.16992500144231237,1,1,non-aligned,non-aligned
19,study7Pie,6.0,59,15,1579,15,pie,set3,0,0,True,-3.0,10,3,non-aligned,non-aligned
19,study7Pie,4.0,60,23,1580,23,pie,set2,0,0,True,-3.0,2,5,non-aligned,non-aligned
19,study7Pie,6.0,61,27,1581,27,pie,set3,0,0,True,-3.0,2,6,non-aligned,non-aligned
19,study7Pie,6.0,62,20,1582,18,pie,set1,2,2,False,1.0874628412503393,7,0,start0,aligned
19,study7Pie,7.0,63,25,1583,31,pie,set1,-6,6,False,2.6147098441152083,6,4,non-aligned,non-aligned
19,study7Pie,7.0,64,34,1584,35,pie,set3,-1,1,False,0.16992500144231237,10,2,non-aligned,non-aligned
19,study7Pie,6.0,65,41,1585,42,pie,set2,-1,1,False,0.16992500144231237,8,0,start0,aligned
19,study7Pie,4.0,66,50,1586,50,pie,set1,0,0,True,-3.0,0,0,start0,aligned
19,study7Pie,6.0,67,30,1587,31,pie,set3,-1,1,False,0.16992500144231237,6,0,start0,aligned
19,study7Pie,5.0,68,21,1588,21,pie,set3,0,0,True,-3.0,4,2,non-aligned,non-aligned
19,study7Pie,6.0,69,25,1589,27,pie,set1,-2,2,False,1.0874628412503393,2,0,start0,aligned
19,study7Pie,5.0,70,32,1590,34,pie,set2,-2,2,False,1.0874628412503393,9,2,non-aligned,non-aligned
19,study7Pie,5.0,71,41,1591,41,pie,set3,0,0,True,-3.0,9,0,start0,aligned
19,study7Pie,5.0,72,50,1592,50,pie,set1,0,0,True,-3.0,0,6,non-aligned,non-aligned
19,study7Pie,6.0,73,45,1593,47,pie,set1,-2,2,False,1.0874628412503393,3,2,non-aligned,non-aligned
19,study7Pie,7.0,74,43,1594,46,pie,set3,-3,3,False,1.6438561897747246,4,10,non-aligned,non-aligned
19,study7Pie,6.0,75,43,1595,45,pie,set2,-2,2,False,1.0874628412503393,5,9,non-aligned,non-aligned
19,study7Pie,6.0,76,11,1596,11,pie,set1,0,0,True,-3.0,11,0,start0,aligned
19,study7Pie,5.0,77,40,1597,43,pie,set4,-3,3,False,1.6438561897747246,7,6,non-aligned,non-aligned
19,study7Pie,6.0,78,33,1598,33,pie,set2,0,0,True,-3.0,8,0,start0,aligned
19,study7Pie,6.0,79,15,1599,15,pie,set1,0,0,True,-3.0,10,0,start0,aligned
34,study7Pie,9.0,0,39,2720,42,pie,set4,-3,3,False,1.6438561897747246,8,1,non-aligned,non-aligned
34,study7Pie,8.0,1,19,2721,11,pie,set1,8,8,False,3.0223678130284544,11,0,start0,aligned
34,study7Pie,10.0,2,18,2722,17,pie,set3,1,1,False,0.16992500144231237,8,0,start0,aligned
34,study7Pie,6.0,3,49,2723,49,pie,set4,0,0,True,-3.0,1,5,non-aligned,non-aligned
34,study7Pie,8.0,4,30,2724,29,pie,set1,1,1,False,0.16992500144231237,4,2,non-aligned,non-aligned
34,study7Pie,7.0,5,42,2725,34,pie,set2,8,8,False,3.0223678130284544,9,2,non-aligned,non-aligned
34,study7Pie,5.0,6,25,2726,22,pie,set2,3,3,False,1.6438561897747246,3,9,non-aligned,non-aligned
34,study7Pie,7.0,7,32,2727,39,pie,set3,-7,7,False,2.8328900141647417,11,0,start0,aligned
34,study7Pie,5.0,8,35,2728,30,pie,set3,5,5,False,2.357552004618084,5,7,non-aligned,non-aligned
34,study7Pie,4.0,9,47,2729,48,pie,set2,-1,1,False,0.16992500144231237,2,0,start0,aligned
34,study7Pie,3.0,10,46,2730,45,pie,set1,1,1,False,0.16992500144231237,5,2,non-aligned,non-aligned
34,study7Pie,2.0,11,48,2731,48,pie,set2,0,0,True,-3.0,2,2,non-aligned,non-aligned
34,study7Pie,5.0,12,16,2732,15,pie,set3,1,1,False,0.16992500144231237,10,3,non-aligned,non-aligned
34,study7Pie,4.0,13,33,2733,33,pie,set3,0,0,True,-3.0,8,0,start0,aligned
34,study7Pie,3.0,14,48,2734,49,pie,set1,-1,1,False,0.16992500144231237,1,0,start0,aligned
34,study7Pie,4.0,15,20,2735,22,pie,set3,-2,2,False,1.0874628412503393,3,0,start0,aligned
34,study7Pie,3.0,16,16,2736,12,pie,set2,4,4,False,2.0443941193584534,12,0,start0,aligned
34,study7Pie,4.0,17,38,2737,33,pie,set1,5,5,False,2.357552004618084,8,6,non-aligned,non-aligned
34,study7Pie,4.0,18,24,2738,24,pie,set2,0,0,True,-3.0,1,0,start0,aligned
34,study7Pie,4.0,19,39,2739,44,pie,set4,-5,5,False,2.357552004618084,6,0,start0,aligned
34,study7Pie,4.0,20,27,2740,27,pie,set2,0,0,True,-3.0,2,0,start0,aligned
34,study7Pie,3.0,21,25,2741,25,pie,set2,0,0,True,-3.0,0,0,start0,aligned
34,study7Pie,3.0,22,25,2742,25,pie,set3,0,0,True,-3.0,0,5,non-aligned,non-aligned
34,study7Pie,4.0,23,15,2743,13,pie,set2,2,2,False,1.0874628412503393,12,6,non-aligned,non-aligned
34,study7Pie,5.0,24,19,2744,16,pie,set2,3,3,False,1.6438561897747246,9,0,start0,aligned
34,study7Pie,4.0,25,36,2745,35,pie,set3,1,1,False,0.16992500144231237,10,0,start0,aligned
34,study7Pie,3.0,26,44,2746,41,pie,set3,3,3,False,1.6438561897747246,9,0,start0,aligned
34,study7Pie,4.0,27,46,2747,40,pie,set3,6,6,False,2.6147098441152083,10,0,start0,aligned
34,study7Pie,4.0,28,45,2748,37,pie,set1,8,8,False,3.0223678130284544,12,6,non-aligned,non-aligned
34,study7Pie,3.0,29,38,2749,37,pie,set2,1,1,False,0.16992500144231237,12,0,start0,aligned
34,study7Pie,5.0,30,20,2750,14,pie,set2,6,6,False,2.6147098441152083,11,4,non-aligned,non-aligned
34,study7Pie,3.0,31,45,2751,47,pie,set4,-2,2,False,1.0874628412503393,3,0,start0,aligned
34,study7Pie,5.0,32,20,2752,20,pie,set3,0,0,True,-3.0,5,2,non-aligned,non-aligned
34,study7Pie,5.0,33,29,2753,29,pie,set2,0,0,True,-3.0,4,0,start0,aligned
34,study7Pie,6.0,34,40,2754,35,pie,set3,5,5,False,2.357552004618084,10,2,non-aligned,non-aligned
34,study7Pie,3.0,35,42,2755,43,pie,set2,-1,1,False,0.16992500144231237,7,2,non-aligned,non-aligned
34,study7Pie,4.0,36,50,2756,50,pie,set2,0,0,True,-3.0,0,0,start0,aligned
34,study7Pie,5.0,37,20,2757,16,pie,set1,4,4,False,2.0443941193584534,9,1,non-aligned,non-aligned
34,study7Pie,4.0,38,28,2758,38,pie,set2,-10,10,False,3.3398500028846247,12,5,non-aligned,non-aligned
34,study7Pie,3.0,39,20,2759,13,pie,set4,7,7,False,2.8328900141647417,12,0,start0,aligned
34,study7Pie,3.0,40,26,2760,26,pie,set4,0,0,True,-3.0,1,0,start0,aligned
34,study7Pie,4.0,41,33,2761,36,pie,set1,-3,3,False,1.6438561897747246,11,3,non-aligned,non-aligned
34,study7Pie,3.0,42,46,2762,45,pie,set4,1,1,False,0.16992500144231237,5,0,start0,aligned
34,study7Pie,3.0,43,43,2763,40,pie,set2,3,3,False,1.6438561897747246,10,1,non-aligned,non-aligned
34,study7Pie,4.0,44,29,2764,19,pie,set2,10,10,False,3.3398500028846247,6,2,non-aligned,non-aligned
34,study7Pie,3.0,45,27,2765,21,pie,set2,6,6,False,2.6147098441152083,4,6,non-aligned,non-aligned
34,study7Pie,3.0,46,27,2766,26,pie,set1,1,1,False,0.16992500144231237,1,3,non-aligned,non-aligned
34,study7Pie,2.0,47,28,2767,19,pie,set1,9,9,False,3.189824558880017,6,0,start0,aligned
34,study7Pie,3.0,48,18,2768,12,pie,set2,6,6,False,2.6147098441152083,12,1,non-aligned,non-aligned
34,study7Pie,2.0,49,17,2769,11,pie,set3,6,6,False,2.6147098441152083,11,5,non-aligned,non-aligned
34,study7Pie,4.0,50,45,2770,42,pie,set3,3,3,False,1.6438561897747246,8,0,start0,aligned
34,study7Pie,3.0,51,21,2771,14,pie,set2,7,7,False,2.8328900141647417,11,0,start0,aligned
34,study7Pie,4.0,52,39,2772,36,pie,set3,3,3,False,1.6438561897747246,11,0,start0,aligned
34,study7Pie,5.0,53,30,2773,30,pie,set1,0,0,True,-3.0,5,0,start0,aligned
34,study7Pie,4.0,54,20,2774,15,pie,set2,5,5,False,2.357552004618084,10,0,start0,aligned
34,study7Pie,4.0,55,46,2775,46,pie,set4,0,0,True,-3.0,4,0,start0,aligned
34,study7Pie,3.0,56,44,2776,34,pie,set1,10,10,False,3.3398500028846247,9,0,start0,aligned
34,study7Pie,3.0,57,29,2777,18,pie,set1,11,11,False,3.4757334309663976,7,1,non-aligned,non-aligned
34,study7Pie,5.0,58,44,2778,43,pie,set4,1,1,False,0.16992500144231237,7,0,start0,aligned
34,study7Pie,4.0,59,25,2779,23,pie,set4,2,2,False,1.0874628412503393,2,10,non-aligned,non-aligned
34,study7Pie,3.0,60,23,2780,20,pie,set2,3,3,False,1.6438561897747246,5,0,start0,aligned
34,study7Pie,3.0,61,24,2781,27,pie,set1,-3,3,False,1.6438561897747246,2,2,non-aligned,non-aligned
34,study7Pie,3.0,62,28,2782,28,pie,set4,0,0,True,-3.0,3,5,non-aligned,non-aligned
34,study7Pie,3.0,63,23,2783,21,pie,set2,2,2,False,1.0874628412503393,4,0,start0,aligned
34,study7Pie,4.0,64,24,2784,24,pie,set4,0,0,True,-3.0,1,9,non-aligned,non-aligned
34,study7Pie,4.0,65,44,2785,39,pie,set1,5,5,False,2.357552004618084,11,4,non-aligned,non-aligned
34,study7Pie,3.0,66,46,2786,46,pie,set4,0,0,True,-3.0,4,2,non-aligned,non-aligned
34,study7Pie,5.0,67,39,2787,32,pie,set1,7,7,False,2.8328900141647417,7,2,non-aligned,non-aligned
34,study7Pie,4.0,68,47,2788,47,pie,set4,0,0,True,-3.0,3,10,non-aligned,non-aligned
34,study7Pie,4.0,69,39,2789,38,pie,set4,1,1,False,0.16992500144231237,12,0,start0,aligned
34,study7Pie,4.0,70,31,2790,31,pie,set3,0,0,True,-3.0,6,0,start0,aligned
34,study7Pie,7.0,71,33,2791,41,pie,set1,-8,8,False,3.0223678130284544,9,6,non-aligned,non-aligned
34,study7Pie,8.0,72,24,2792,17,pie,set2,7,7,False,2.8328900141647417,8,5,non-aligned,non-aligned
34,study7Pie,3.0,73,22,2793,23,pie,set1,-1,1,False,0.16992500144231237,2,0,start0,aligned
34,study7Pie,4.0,74,29,2794,31,pie,set2,-2,2,False,1.0874628412503393,6,1,non-aligned,non-aligned
34,study7Pie,3.0,75,32,2795,32,pie,set2,0,0,True,-3.0,7,0,start0,aligned
34,study7Pie,3.0,76,24,2796,18,pie,set2,6,6,False,2.6147098441152083,7,0,start0,aligned
34,study7Pie,4.0,77,29,2797,28,pie,set3,1,1,False,0.16992500144231237,3,0,start0,aligned
34,study7Pie,4.0,78,45,2798,44,pie,set1,1,1,False,0.16992500144231237,6,2,non-aligned,non-aligned
34,study7Pie,5.0,79,48,2799,50,pie,set2,-2,2,False,1.0874628412503393,0,4,non-aligned,non-aligned
28,study7Pie,27.0,0,38,2240,40,pie,set3,-2,2,False,1.0874628412503393,10,2,non-aligned,non-aligned
28,study7Pie,13.0,1,46,2241,47,pie,set2,-1,1,False,0.16992500144231237,3,0,start0,aligned
28,study7Pie,18.0,2,12,2242,12,pie,set2,0,0,True,-3.0,12,0,start0,aligned
28,study7Pie,10.0,3,46,2243,46,pie,set4,0,0,True,-3.0,4,2,non-aligned,non-aligned
28,study7Pie,215.0,4,30,2244,31,pie,set3,-1,1,False,0.16992500144231237,6,0,start0,aligned
28,study7Pie,14.0,5,26,2245,26,pie,set1,0,0,True,-3.0,1,0,start0,aligned
28,study7Pie,11.0,6,30,2246,32,pie,set4,-2,2,False,1.0874628412503393,7,0,start0,aligned
28,study7Pie,7.0,7,20,2247,19,pie,set3,1,1,False,0.16992500144231237,6,0,start0,aligned
28,study7Pie,7.0,8,48,2248,49,pie,set3,-1,1,False,0.16992500144231237,1,1,non-aligned,non-aligned
28,study7Pie,27.0,9,12,2249,13,pie,set2,-1,1,False,0.16992500144231237,12,6,non-aligned,non-aligned
28,study7Pie,13.0,10,45,2250,43,pie,set2,2,2,False,1.0874628412503393,7,2,non-aligned,non-aligned
28,study7Pie,24.0,11,35,2251,33,pie,set3,2,2,False,1.0874628412503393,8,0,start0,aligned
28,study7Pie,8.0,12,20,2252,20,pie,set4,0,0,True,-3.0,5,5,non-aligned,non-aligned
28,study7Pie,18.0,13,22,2253,22,pie,set3,0,0,True,-3.0,3,0,start0,aligned
28,study7Pie,13.0,14,23,2254,21,pie,set4,2,2,False,1.0874628412503393,4,2,non-aligned,non-aligned
28,study7Pie,5.0,15,15,2255,15,pie,set1,0,0,True,-3.0,10,0,start0,aligned
28,study7Pie,8.0,16,47,2256,46,pie,set4,1,1,False,0.16992500144231237,4,0,start0,aligned
28,study7Pie,12.0,17,15,2257,12,pie,set3,3,3,False,1.6438561897747246,12,1,non-aligned,non-aligned
28,study7Pie,14.0,18,40,2258,41,pie,set4,-1,1,False,0.16992500144231237,9,0,start0,aligned
28,study7Pie,24.0,19,20,2259,25,pie,set3,-5,5,False,2.357552004618084,0,5,non-aligned,non-aligned
28,study7Pie,15.0,20,20,2260,20,pie,set3,0,0,True,-3.0,5,0,start0,aligned
28,study7Pie,49.0,21,35,2261,35,pie,set2,0,0,True,-3.0,10,3,non-aligned,non-aligned
28,study7Pie,11.0,22,46,2262,45,pie,set1,1,1,False,0.16992500144231237,5,0,start0,aligned
28,study7Pie,41.0,23,40,2263,32,pie,set4,8,8,False,3.0223678130284544,7,7,non-aligned,non-aligned
28,study7Pie,18.0,24,27,2264,27,pie,set3,0,0,True,-3.0,2,0,start0,aligned
28,study7Pie,12.0,25,50,2265,50,pie,set3,0,0,True,-3.0,0,5,non-aligned,non-aligned
28,study7Pie,6.0,26,25,2266,25,pie,set1,0,0,True,-3.0,0,0,start0,aligned
28,study7Pie,8.0,27,32,2267,36,pie,set1,-4,4,False,2.0443941193584534,11,3,non-aligned,non-aligned
28,study7Pie,6.0,28,30,2268,34,pie,set1,-4,4,False,2.0443941193584534,9,0,start0,aligned
28,study7Pie,5.0,29,50,2269,49,pie,set1,1,1,False,0.16992500144231237,1,0,start0,aligned
28,study7Pie,8.0,30,40,2270,34,pie,set3,6,6,False,2.6147098441152083,9,3,non-aligned,non-aligned
28,study7Pie,17.0,31,42,2271,42,pie,set3,0,0,True,-3.0,8,0,start0,aligned
28,study7Pie,7.0,32,23,2272,22,pie,set1,1,1,False,0.16992500144231237,3,2,non-aligned,non-aligned
28,study7Pie,9.0,33,46,2273,48,pie,set2,-2,2,False,1.0874628412503393,2,2,non-aligned,non-aligned
28,study7Pie,10.0,34,25,2274,27,pie,set2,-2,2,False,1.0874628412503393,2,11,non-aligned,non-aligned
28,study7Pie,8.0,35,22,2275,23,pie,set1,-1,1,False,0.16992500144231237,2,0,start0,aligned
28,study7Pie,6.0,36,30,2276,31,pie,set4,-1,1,False,0.16992500144231237,6,0,end50,aligned
28,study7Pie,7.0,37,35,2277,37,pie,set3,-2,2,False,1.0874628412503393,12,0,start25,aligned
28,study7Pie,21.0,38,15,2278,14,pie,set1,1,1,False,0.16992500144231237,11,0,start0,aligned
28,study7Pie,6.0,39,25,2279,29,pie,set4,-4,4,False,2.0443941193584534,4,3,non-aligned,non-aligned
28,study7Pie,8.0,40,27,2280,33,pie,set2,-6,6,False,2.6147098441152083,8,8,non-aligned,non-aligned
28,study7Pie,13.0,41,28,2281,30,pie,set2,-2,2,False,1.0874628412503393,5,0,start0,aligned
28,study7Pie,7.0,42,17,2282,14,pie,set3,3,3,False,1.6438561897747246,11,2,non-aligned,non-aligned
28,study7Pie,19.0,43,20,2283,18,pie,set3,2,2,False,1.0874628412503393,7,2,non-aligned,non-aligned
28,study7Pie,10.0,44,24,2284,24,pie,set2,0,0,True,-3.0,1,0,start0,aligned
28,study7Pie,576.0,45,45,2285,45,pie,set2,0,0,True,-3.0,5,9,non-aligned,non-aligned
28,study7Pie,84.0,46,47,2286,47,pie,set2,0,0,True,-3.0,3,2,non-aligned,non-aligned
28,study7Pie,8.0,47,45,2287,39,pie,set4,6,6,False,2.6147098441152083,11,0,start0,aligned
28,study7Pie,7.0,48,15,2288,13,pie,set1,2,2,False,1.0874628412503393,12,0,start0,aligned
28,study7Pie,4.0,49,20,2289,17,pie,set2,3,3,False,1.6438561897747246,8,5,non-aligned,non-aligned
28,study7Pie,7.0,50,20,2290,19,pie,set1,1,1,False,0.16992500144231237,6,8,non-aligned,non-aligned
28,study7Pie,7.0,51,50,2291,50,pie,set1,0,0,True,-3.0,0,0,start0,aligned
28,study7Pie,5.0,52,33,2292,37,pie,set4,-4,4,False,2.0443941193584534,12,0,start0,aligned
28,study7Pie,7.0,53,48,2293,48,pie,set4,0,0,True,-3.0,2,0,start0,aligned
28,study7Pie,5.0,54,10,2294,11,pie,set4,-1,1,False,0.16992500144231237,11,0,start0,aligned
28,study7Pie,12.0,55,43,2295,44,pie,set4,-1,1,False,0.16992500144231237,6,2,non-aligned,non-aligned
28,study7Pie,5.0,56,25,2296,26,pie,set4,-1,1,False,0.16992500144231237,1,1,non-aligned,non-aligned
28,study7Pie,8.0,57,30,2297,36,pie,set3,-6,6,False,2.6147098441152083,11,0,start0,aligned
28,study7Pie,7.0,58,27,2298,29,pie,set2,-2,2,False,1.0874628412503393,4,0,start0,aligned
28,study7Pie,7.0,59,40,2299,44,pie,set1,-4,4,False,2.0443941193584534,6,0,start0,aligned
28,study7Pie,7.0,60,25,2300,23,pie,set2,2,2,False,1.0874628412503393,2,5,non-aligned,non-aligned
28,study7Pie,13.0,61,38,2301,40,pie,set1,-2,2,False,1.0874628412503393,10,0,start0,aligned
28,study7Pie,5.0,62,26,2302,24,pie,set2,2,2,False,1.0874628412503393,1,2,non-aligned,non-aligned
28,study7Pie,7.0,63,34,2303,30,pie,set2,4,4,False,2.0443941193584534,5,4,non-aligned,non-aligned
28,study7Pie,17.0,64,38,2304,39,pie,set4,-1,1,False,0.16992500144231237,11,1,non-aligned,non-aligned
28,study7Pie,6.0,65,40,2305,38,pie,set3,2,2,False,1.0874628412503393,12,0,start0,aligned
28,study7Pie,6.0,66,22,2306,21,pie,set4,1,1,False,0.16992500144231237,4,0,start0,aligned
28,study7Pie,5.0,67,17,2307,16,pie,set1,1,1,False,0.16992500144231237,9,0,start0,aligned
28,study7Pie,6.0,68,28,2308,28,pie,set3,0,0,True,-3.0,3,9,non-aligned,non-aligned
28,study7Pie,4.0,69,12,2309,11,pie,set2,1,1,False,0.16992500144231237,11,2,non-aligned,non-aligned
28,study7Pie,16.0,70,45,2310,43,pie,set2,2,2,False,1.0874628412503393,7,0,start0,aligned
28,study7Pie,19.0,71,36,2311,35,pie,set3,1,1,False,0.16992500144231237,10,0,start0,aligned
28,study7Pie,14.0,72,40,2312,38,pie,set2,2,2,False,1.0874628412503393,12,5,non-aligned,non-aligned
28,study7Pie,9.0,73,22,2313,17,pie,set4,5,5,False,2.357552004618084,8,0,start0,aligned
28,study7Pie,10.0,74,17,2314,16,pie,set3,1,1,False,0.16992500144231237,9,3,non-aligned,non-aligned
28,study7Pie,5.0,75,15,2315,15,pie,set3,0,0,True,-3.0,10,3,non-aligned,non-aligned
28,study7Pie,14.0,76,21,2316,18,pie,set3,3,3,False,1.6438561897747246,7,0,start0,aligned
28,study7Pie,6.0,77,27,2317,28,pie,set3,-1,1,False,0.16992500144231237,3,0,start0,aligned
28,study7Pie,25.0,78,43,2318,41,pie,set2,2,2,False,1.0874628412503393,9,4,non-aligned,non-aligned
28,study7Pie,14.0,79,42,2319,42,pie,set3,0,0,True,-3.0,8,7,non-aligned,non-aligned
13,study7Pie,31.0,0,25,1040,29,pie,set1,-4,4,False,2.0443941193584534,4,2,non-aligned,non-aligned
13,study7Pie,30.0,1,40,1041,36,pie,set3,4,4,False,2.0443941193584534,11,3,non-aligned,non-aligned
13,study7Pie,16.0,2,44,1042,43,pie,set1,1,1,False,0.16992500144231237,7,2,non-aligned,non-aligned
13,study7Pie,17.0,3,20,1043,20,pie,set4,0,0,True,-3.0,5,0,start0,aligned
13,study7Pie,9.0,4,50,1044,50,pie,set2,0,0,True,-3.0,0,0,start0,aligned
13,study7Pie,13.0,5,22,1045,22,pie,set4,0,0,True,-3.0,3,0,start75,aligned
13,study7Pie,18.0,6,45,1046,38,pie,set3,7,7,False,2.8328900141647417,12,3,non-aligned,non-aligned
13,study7Pie,14.0,7,30,1047,30,pie,set3,0,0,True,-3.0,5,0,start0,aligned
13,study7Pie,17.0,8,27,1048,26,pie,set3,1,1,False,0.16992500144231237,1,0,start0,aligned
13,study7Pie,16.0,9,12,1049,11,pie,set2,1,1,False,0.16992500144231237,11,0,start0,aligned
13,study7Pie,19.0,10,30,1050,35,pie,set4,-5,5,False,2.357552004618084,10,0,end100,aligned
13,study7Pie,17.0,11,15,1051,17,pie,set4,-2,2,False,1.0874628412503393,8,1,non-aligned,non-aligned
13,study7Pie,10.0,12,23,1052,23,pie,set2,0,0,True,-3.0,2,0,start0,aligned
13,study7Pie,20.0,13,20,1053,18,pie,set3,2,2,False,1.0874628412503393,7,0,start0,aligned
13,study7Pie,9.0,14,50,1054,50,pie,set2,0,0,True,-3.0,0,4,non-aligned,non-aligned
13,study7Pie,21.0,15,15,1055,14,pie,set3,1,1,False,0.16992500144231237,11,2,non-aligned,non-aligned
13,study7Pie,9.0,16,45,1056,42,pie,set2,3,3,False,1.6438561897747246,8,0,start0,aligned
13,study7Pie,10.0,17,40,1057,37,pie,set2,3,3,False,1.6438561897747246,12,5,non-aligned,non-aligned
13,study7Pie,16.0,18,27,1058,33,pie,set1,-6,6,False,2.6147098441152083,8,6,non-aligned,non-aligned
13,study7Pie,9.0,19,30,1059,36,pie,set1,-6,6,False,2.6147098441152083,11,0,start0,aligned
13,study7Pie,21.0,20,30,1060,31,pie,set4,-1,1,False,0.16992500144231237,6,0,end50,aligned
13,study7Pie,12.0,21,15,1061,15,pie,set4,0,0,True,-3.0,10,0,start0,aligned
13,study7Pie,8.0,22,45,1062,48,pie,set1,-3,3,False,1.6438561897747246,2,9,non-aligned,non-aligned
13,study7Pie,9.0,23,25,1063,25,pie,set4,0,0,True,-3.0,0,0,start0,aligned
13,study7Pie,7.0,24,45,1064,49,pie,set4,-4,4,False,2.0443941193584534,1,5,non-aligned,non-aligned
13,study7Pie,9.0,25,40,1065,44,pie,set4,-4,4,False,2.0443941193584534,6,2,non-aligned,non-aligned
13,study7Pie,18.0,26,20,1066,21,pie,set1,-1,1,False,0.16992500144231237,4,1,non-aligned,non-aligned
13,study7Pie,9.0,27,15,1067,12,pie,set3,3,3,False,1.6438561897747246,12,1,non-aligned,non-aligned
13,study7Pie,13.0,28,35,1068,34,pie,set4,1,1,False,0.16992500144231237,9,0,start0,aligned
13,study7Pie,7.0,29,40,1069,45,pie,set1,-5,5,False,2.357552004618084,5,2,non-aligned,non-aligned
13,study7Pie,10.0,30,30,1070,35,pie,set1,-5,5,False,2.357552004618084,10,0,start0,aligned
13,study7Pie,6.0,31,23,1071,22,pie,set1,1,1,False,0.16992500144231237,3,0,start0,aligned
13,study7Pie,7.0,32,15,1072,11,pie,set3,4,4,False,2.0443941193584534,11,5,non-aligned,non-aligned
13,study7Pie,13.0,33,45,1073,44,pie,set2,1,1,False,0.16992500144231237,6,0,start0,aligned
13,study7Pie,7.0,34,40,1074,34,pie,set4,6,6,False,2.6147098441152083,9,2,non-aligned,non-aligned
13,study7Pie,10.0,35,22,1075,21,pie,set3,1,1,False,0.16992500144231237,4,0,start0,aligned
13,study7Pie,6.0,36,20,1076,17,pie,set2,3,3,False,1.6438561897747246,8,0,start0,aligned
13,study7Pie,11.0,37,20,1077,26,pie,set2,-6,6,False,2.6147098441152083,1,10,non-aligned,non-aligned
13,study7Pie,12.0,38,37,1078,40,pie,set1,-3,3,False,1.6438561897747246,10,6,non-aligned,non-aligned
13,study7Pie,11.0,39,40,1079,41,pie,set2,-1,1,False,0.16992500144231237,9,0,start0,aligned
13,study7Pie,6.0,40,45,1080,46,pie,set3,-1,1,False,0.16992500144231237,4,0,start0,aligned
13,study7Pie,9.0,41,20,1081,19,pie,set2,1,1,False,0.16992500144231237,6,0,start0,aligned
13,study7Pie,5.0,42,30,1082,30,pie,set4,0,0,True,-3.0,5,1,non-aligned,non-aligned
13,study7Pie,8.0,43,30,1083,29,pie,set4,1,1,False,0.16992500144231237,4,0,start0,aligned
13,study7Pie,16.0,44,37,1084,37,pie,set4,0,0,True,-3.0,12,0,start0,aligned
13,study7Pie,6.0,45,45,1085,47,pie,set4,-2,2,False,1.0874628412503393,3,10,non-aligned,non-aligned
13,study7Pie,6.0,46,20,1086,19,pie,set3,1,1,False,0.16992500144231237,6,1,non-aligned,non-aligned
13,study7Pie,5.0,47,27,1087,28,pie,set2,-1,1,False,0.16992500144231237,3,0,start0,aligned
13,study7Pie,20.0,48,15,1088,18,pie,set3,-3,3,False,1.6438561897747246,7,2,non-aligned,non-aligned
13,study7Pie,11.0,49,15,1089,13,pie,set4,2,2,False,1.0874628412503393,12,6,non-aligned,non-aligned
13,study7Pie,14.0,50,25,1090,25,pie,set1,0,0,True,-3.0,0,7,non-aligned,non-aligned
13,study7Pie,5.0,51,45,1091,41,pie,set1,4,4,False,2.0443941193584534,9,6,non-aligned,non-aligned
13,study7Pie,7.0,52,40,1092,43,pie,set2,-3,3,False,1.6438561897747246,7,0,start0,aligned
13,study7Pie,6.0,53,25,1093,28,pie,set1,-3,3,False,1.6438561897747246,3,10,non-aligned,non-aligned
13,study7Pie,8.0,54,20,1094,24,pie,set1,-4,4,False,2.0443941193584534,1,0,start0,aligned
13,study7Pie,16.0,55,20,1095,16,pie,set4,4,4,False,2.0443941193584534,9,0,start0,aligned
13,study7Pie,6.0,56,45,1096,46,pie,set4,-1,1,False,0.16992500144231237,4,2,non-aligned,non-aligned
13,study7Pie,6.0,57,40,1097,38,pie,set4,2,2,False,1.0874628412503393,12,0,start0,aligned
13,study7Pie,5.0,58,25,1098,23,pie,set4,2,2,False,1.0874628412503393,2,10,non-aligned,non-aligned
13,study7Pie,8.0,59,48,1099,49,pie,set4,-1,1,False,0.16992500144231237,1,0,start0,aligned
13,study7Pie,12.0,60,30,1100,33,pie,set1,-3,3,False,1.6438561897747246,8,0,start0,aligned
13,study7Pie,14.0,61,40,1101,39,pie,set1,1,1,False,0.16992500144231237,11,4,non-aligned,non-aligned
13,study7Pie,12.0,62,15,1102,14,pie,set4,1,1,False,0.16992500144231237,11,0,start0,aligned
13,study7Pie,6.0,63,45,1103,48,pie,set3,-3,3,False,1.6438561897747246,2,0,start0,aligned
13,study7Pie,6.0,64,30,1104,31,pie,set1,-1,1,False,0.16992500144231237,6,0,start0,aligned
13,study7Pie,9.0,65,27,1105,27,pie,set1,0,0,True,-3.0,2,2,non-aligned,non-aligned
13,study7Pie,13.0,66,17,1106,15,pie,set2,2,2,False,1.0874628412503393,10,4,non-aligned,non-aligned
13,study7Pie,6.0,67,27,1107,27,pie,set4,0,0,True,-3.0,2,0,start0,aligned
13,study7Pie,6.0,68,45,1108,47,pie,set3,-2,2,False,1.0874628412503393,3,0,start0,aligned
13,study7Pie,10.0,69,13,1109,13,pie,set2,0,0,True,-3.0,12,0,start0,aligned
13,study7Pie,16.0,70,20,1110,24,pie,set2,-4,4,False,2.0443941193584534,1,2,non-aligned,non-aligned
13,study7Pie,6.0,71,40,1111,40,pie,set3,0,0,True,-3.0,10,0,start0,aligned
13,study7Pie,6.0,72,30,1112,32,pie,set3,-2,2,False,1.0874628412503393,7,0,start0,aligned
13,study7Pie,13.0,73,18,1113,16,pie,set1,2,2,False,1.0874628412503393,9,1,non-aligned,non-aligned
13,study7Pie,6.0,74,45,1114,42,pie,set2,3,3,False,1.6438561897747246,8,4,non-aligned,non-aligned
13,study7Pie,9.0,75,28,1115,32,pie,set1,-4,4,False,2.0443941193584534,7,2,non-aligned,non-aligned
13,study7Pie,10.0,76,44,1116,45,pie,set4,-1,1,False,0.16992500144231237,5,0,start0,aligned
13,study7Pie,10.0,77,38,1117,39,pie,set3,-1,1,False,0.16992500144231237,11,0,start0,aligned
13,study7Pie,10.0,78,20,1118,20,pie,set3,0,0,True,-3.0,5,2,non-aligned,non-aligned
13,study7Pie,10.0,79,12,1119,12,pie,set4,0,0,True,-3.0,12,0,start0,aligned
7,study7Pie,17.0,0,20,560,21,pie,set3,-1,1,False,0.16992500144231237,4,0,start0,aligned
7,study7Pie,9.0,1,35,561,34,pie,set1,1,1,False,0.16992500144231237,9,0,start0,aligned
7,study7Pie,10.0,2,18,562,22,pie,set4,-4,4,False,2.0443941193584534,3,0,start0,aligned
7,study7Pie,10.0,3,13,563,11,pie,set2,2,2,False,1.0874628412503393,11,2,non-aligned,non-aligned
7,study7Pie,7.0,4,45,564,43,pie,set1,2,2,False,1.0874628412503393,7,0,start0,aligned
7,study7Pie,8.0,5,37,565,33,pie,set3,4,4,False,2.0443941193584534,8,0,start0,aligned
7,study7Pie,10.0,6,23,566,24,pie,set1,-1,1,False,0.16992500144231237,1,5,non-aligned,non-aligned
7,study7Pie,10.0,7,26,567,26,pie,set4,0,0,True,-3.0,1,0,start0,aligned
7,study7Pie,9.0,8,46,568,45,pie,set3,1,1,False,0.16992500144231237,5,0,start0,aligned
7,study7Pie,9.0,9,13,569,13,pie,set3,0,0,True,-3.0,12,0,start0,aligned
7,study7Pie,7.0,10,28,570,29,pie,set2,-1,1,False,0.16992500144231237,4,0,start0,aligned
7,study7Pie,8.0,11,43,571,42,pie,set2,1,1,False,0.16992500144231237,8,0,start0,aligned
7,study7Pie,10.0,12,13,572,14,pie,set3,-1,1,False,0.16992500144231237,11,2,non-aligned,non-aligned
7,study7Pie,12.0,13,21,573,20,pie,set3,1,1,False,0.16992500144231237,5,2,non-aligned,non-aligned
7,study7Pie,9.0,14,42,574,39,pie,set3,3,3,False,1.6438561897747246,11,0,start0,aligned
7,study7Pie,5.0,15,10,575,11,pie,set1,-1,1,False,0.16992500144231237,11,0,start0,aligned
7,study7Pie,9.0,16,11,576,12,pie,set3,-1,1,False,0.16992500144231237,12,1,non-aligned,non-aligned
7,study7Pie,9.0,17,48,577,47,pie,set4,1,1,False,0.16992500144231237,3,0,start0,aligned
7,study7Pie,8.0,18,17,578,23,pie,set2,-6,6,False,2.6147098441152083,2,5,non-aligned,non-aligned
7,study7Pie,7.0,19,27,579,28,pie,set1,-1,1,False,0.16992500144231237,3,0,start0,aligned
7,study7Pie,7.0,20,40,580,41,pie,set4,-1,1,False,0.16992500144231237,9,0,start0,aligned
7,study7Pie,12.0,21,41,581,37,pie,set4,4,4,False,2.0443941193584534,12,1,non-aligned,non-aligned
7,study7Pie,7.0,22,23,582,23,pie,set4,0,0,True,-3.0,2,0,start0,aligned
7,study7Pie,10.0,23,44,583,40,pie,set4,4,4,False,2.0443941193584534,10,2,non-aligned,non-aligned
7,study7Pie,8.0,24,45,584,40,pie,set4,5,5,False,2.357552004618084,10,0,start0,aligned
7,study7Pie,7.0,25,49,585,49,pie,set4,0,0,True,-3.0,1,5,non-aligned,non-aligned
7,study7Pie,6.0,26,48,586,45,pie,set4,3,3,False,1.6438561897747246,5,7,non-aligned,non-aligned
7,study7Pie,8.0,27,24,587,27,pie,set3,-3,3,False,1.6438561897747246,2,6,non-aligned,non-aligned
7,study7Pie,9.0,28,23,588,28,pie,set3,-5,5,False,2.357552004618084,3,9,non-aligned,non-aligned
7,study7Pie,8.0,29,32,589,34,pie,set4,-2,2,False,1.0874628412503393,9,2,non-aligned,non-aligned
7,study7Pie,8.0,30,20,590,16,pie,set1,4,4,False,2.0443941193584534,9,1,non-aligned,non-aligned
7,study7Pie,5.0,31,49,591,49,pie,set2,0,0,True,-3.0,1,0,start0,aligned
7,study7Pie,5.0,32,43,592,38,pie,set1,5,5,False,2.357552004618084,12,1,non-aligned,non-aligned
7,study7Pie,6.0,33,23,593,24,pie,set4,-1,1,False,0.16992500144231237,1,0,start0,aligned
7,study7Pie,7.0,34,25,594,26,pie,set3,-1,1,False,0.16992500144231237,1,3,non-aligned,non-aligned
7,study7Pie,6.0,35,32,595,32,pie,set3,0,0,True,-3.0,7,2,non-aligned,non-aligned
7,study7Pie,6.0,36,20,596,18,pie,set4,2,2,False,1.0874628412503393,7,3,non-aligned,non-aligned
7,study7Pie,5.0,37,47,597,46,pie,set2,1,1,False,0.16992500144231237,4,0,start0,aligned
7,study7Pie,7.0,38,35,598,37,pie,set1,-2,2,False,1.0874628412503393,12,0,start0,aligned
7,study7Pie,4.0,39,49,599,48,pie,set2,1,1,False,0.16992500144231237,2,0,start0,aligned
7,study7Pie,8.0,40,48,600,48,pie,set4,0,0,True,-3.0,2,2,non-aligned,non-aligned
7,study7Pie,5.0,41,25,601,25,pie,set4,0,0,True,-3.0,0,0,start0,aligned
7,study7Pie,6.0,42,47,602,47,pie,set4,0,0,True,-3.0,3,10,non-aligned,non-aligned
7,study7Pie,5.0,43,36,603,36,pie,set4,0,0,True,-3.0,11,0,start0,aligned
7,study7Pie,6.0,44,19,604,13,pie,set3,6,6,False,2.6147098441152083,12,2,non-aligned,non-aligned
7,study7Pie,8.0,45,39,605,38,pie,set1,1,1,False,0.16992500144231237,12,0,start0,aligned
7,study7Pie,10.0,46,16,606,12,pie,set4,4,4,False,2.0443941193584534,12,0,start0,aligned
7,study7Pie,6.0,47,42,607,39,pie,set2,3,3,False,1.6438561897747246,11,1,non-aligned,non-aligned
7,study7Pie,6.0,48,34,608,31,pie,set1,3,3,False,1.6438561897747246,6,0,start0,aligned
7,study7Pie,7.0,49,25,609,25,pie,set2,0,0,True,-3.0,0,8,non-aligned,non-aligned
7,study7Pie,7.0,50,20,610,17,pie,set4,3,3,False,1.6438561897747246,8,0,start0,aligned
7,study7Pie,5.0,51,19,611,14,pie,set4,5,5,False,2.357552004618084,11,0,start0,aligned
7,study7Pie,5.0,52,28,612,30,pie,set1,-2,2,False,1.0874628412503393,5,0,start0,aligned
7,study7Pie,9.0,53,26,613,33,pie,set2,-7,7,False,2.8328900141647417,8,8,non-aligned,non-aligned
7,study7Pie,9.0,54,21,614,19,pie,set2,2,2,False,1.0874628412503393,6,0,start0,aligned
7,study7Pie,6.0,55,18,615,15,pie,set4,3,3,False,1.6438561897747246,10,0,start0,aligned
7,study7Pie,9.0,56,31,616,31,pie,set4,0,0,True,-3.0,6,0,end50,aligned
7,study7Pie,7.0,57,19,617,18,pie,set2,1,1,False,0.16992500144231237,7,0,start0,aligned
7,study7Pie,5.0,58,50,618,50,pie,set1,0,0,True,-3.0,0,0,start0,aligned
7,study7Pie,6.0,59,44,619,36,pie,set1,8,8,False,3.0223678130284544,11,3,non-aligned,non-aligned
7,study7Pie,5.0,60,50,620,50,pie,set3,0,0,True,-3.0,0,5,non-aligned,non-aligned
7,study7Pie,10.0,61,43,621,35,pie,set1,8,8,False,3.0223678130284544,10,6,non-aligned,non-aligned
7,study7Pie,4.0,62,27,622,27,pie,set4,0,0,True,-3.0,2,0,start0,aligned
7,study7Pie,8.0,63,29,623,29,pie,set3,0,0,True,-3.0,4,9,non-aligned,non-aligned
7,study7Pie,7.0,64,31,624,30,pie,set2,1,1,False,0.16992500144231237,5,4,non-aligned,non-aligned
7,study7Pie,7.0,65,41,625,42,pie,set2,-1,1,False,0.16992500144231237,8,4,non-aligned,non-aligned
7,study7Pie,9.0,66,18,626,21,pie,set2,-3,3,False,1.6438561897747246,4,6,non-aligned,non-aligned
7,study7Pie,4.0,67,33,627,32,pie,set2,1,1,False,0.16992500144231237,7,0,start0,aligned
7,study7Pie,5.0,68,20,628,17,pie,set1,3,3,False,1.6438561897747246,8,0,start25,aligned
7,study7Pie,7.0,69,17,629,19,pie,set4,-2,2,False,1.0874628412503393,6,0,end75,aligned
7,study7Pie,5.0,70,46,630,44,pie,set1,2,2,False,1.0874628412503393,6,2,non-aligned,non-aligned
7,study7Pie,4.0,71,18,631,22,pie,set1,-4,4,False,2.0443941193584534,3,2,non-aligned,non-aligned
7,study7Pie,8.0,72,44,632,44,pie,set1,0,0,True,-3.0,6,0,start0,aligned
7,study7Pie,6.0,73,42,633,41,pie,set3,1,1,False,0.16992500144231237,9,1,non-aligned,non-aligned
7,study7Pie,5.0,74,19,634,16,pie,set4,3,3,False,1.6438561897747246,9,0,start0,aligned
7,study7Pie,7.0,75,45,635,46,pie,set2,-1,1,False,0.16992500144231237,4,9,non-aligned,non-aligned
7,study7Pie,7.0,76,21,636,20,pie,set3,1,1,False,0.16992500144231237,5,0,start0,aligned
7,study7Pie,5.0,77,34,637,35,pie,set2,-1,1,False,0.16992500144231237,10,0,start0,aligned
7,study7Pie,6.0,78,46,638,43,pie,set4,3,3,False,1.6438561897747246,7,6,non-aligned,non-aligned
7,study7Pie,5.0,79,16,639,15,pie,set4,1,1,False,0.16992500144231237,10,4,non-aligned,non-aligned
21,study7Pie,20.0,0,42,1680,44,pie,set4,-2,2,False,1.0874628412503393,6,2,non-aligned,non-aligned
21,study7Pie,13.0,1,21,1681,20,pie,set1,1,1,False,0.16992500144231237,5,0,start0,aligned
21,study7Pie,6.0,2,42,1682,41,pie,set2,1,1,False,0.16992500144231237,9,4,non-aligned,non-aligned
21,study7Pie,4.0,3,16,1683,15,pie,set4,1,1,False,0.16992500144231237,10,0,start0,aligned
21,study7Pie,6.0,4,23,1684,23,pie,set4,0,0,True,-3.0,2,10,non-aligned,non-aligned
21,study7Pie,4.0,5,49,1685,49,pie,set3,0,0,True,-3.0,1,1,non-aligned,non-aligned
21,study7Pie,4.0,6,46,1686,45,pie,set1,1,1,False,0.16992500144231237,5,2,non-aligned,non-aligned
21,study7Pie,3.0,7,23,1687,21,pie,set4,2,2,False,1.0874628412503393,4,0,start0,aligned
21,study7Pie,6.0,8,37,1688,37,pie,set3,0,0,True,-3.0,12,0,start0,aligned
21,study7Pie,3.0,9,45,1689,42,pie,set4,3,3,False,1.6438561897747246,8,0,start0,aligned
21,study7Pie,5.0,10,44,1690,46,pie,set4,-2,2,False,1.0874628412503393,4,2,non-aligned,non-aligned
21,study7Pie,3.0,11,46,1691,46,pie,set1,0,0,True,-3.0,4,0,start0,aligned
21,study7Pie,4.0,12,27,1692,27,pie,set4,0,0,True,-3.0,2,3,non-aligned,non-aligned
21,study7Pie,4.0,13,50,1693,50,pie,set2,0,0,True,-3.0,0,0,start0,aligned
21,study7Pie,6.0,14,14,1694,14,pie,set3,0,0,True,-3.0,11,2,non-aligned,non-aligned
21,study7Pie,3.0,15,49,1695,49,pie,set2,0,0,True,-3.0,1,0,start0,aligned
21,study7Pie,5.0,16,14,1696,14,pie,set1,0,0,True,-3.0,11,0,start0,aligned
21,study7Pie,5.0,17,19,1697,16,pie,set4,3,3,False,1.6438561897747246,9,0,start0,aligned
21,study7Pie,4.0,18,31,1698,32,pie,set2,-1,1,False,0.16992500144231237,7,6,non-aligned,non-aligned
21,study7Pie,3.0,19,32,1699,33,pie,set1,-1,1,False,0.16992500144231237,8,0,start0,aligned
21,study7Pie,2.0,20,25,1700,25,pie,set3,0,0,True,-3.0,0,0,start0,aligned
21,study7Pie,4.0,21,26,1701,26,pie,set2,0,0,True,-3.0,1,0,start0,aligned
21,study7Pie,2.0,22,31,1702,33,pie,set3,-2,2,False,1.0874628412503393,8,3,non-aligned,non-aligned
21,study7Pie,3.0,23,35,1703,34,pie,set1,1,1,False,0.16992500144231237,9,0,start0,aligned
21,study7Pie,2.0,24,44,1704,45,pie,set1,-1,1,False,0.16992500144231237,5,0,start0,aligned
21,study7Pie,3.0,25,40,1705,40,pie,set3,0,0,True,-3.0,10,0,start0,aligned
21,study7Pie,4.0,26,27,1706,27,pie,set2,0,0,True,-3.0,2,0,start0,aligned
21,study7Pie,3.0,27,25,1707,25,pie,set2,0,0,True,-3.0,0,8,non-aligned,non-aligned
21,study7Pie,4.0,28,39,1708,38,pie,set4,1,1,False,0.16992500144231237,12,6,non-aligned,non-aligned
21,study7Pie,4.0,29,50,1709,50,pie,set2,0,0,True,-3.0,0,4,non-aligned,non-aligned
21,study7Pie,2.0,30,28,1710,30,pie,set1,-2,2,False,1.0874628412503393,5,0,start0,aligned
21,study7Pie,3.0,31,47,1711,47,pie,set2,0,0,True,-3.0,3,0,start0,aligned
21,study7Pie,3.0,32,43,1712,42,pie,set4,1,1,False,0.16992500144231237,8,1,non-aligned,non-aligned
21,study7Pie,3.0,33,31,1713,36,pie,set4,-5,5,False,2.357552004618084,11,3,non-aligned,non-aligned
21,study7Pie,3.0,34,29,1714,31,pie,set2,-2,2,False,1.0874628412503393,6,0,start0,aligned
21,study7Pie,3.0,35,29,1715,29,pie,set3,0,0,True,-3.0,4,9,non-aligned,non-aligned
21,study7Pie,3.0,36,31,1716,37,pie,set2,-6,6,False,2.6147098441152083,12,5,non-aligned,non-aligned
21,study7Pie,4.0,37,21,1717,19,pie,set3,2,2,False,1.0874628412503393,6,0,start0,aligned
21,study7Pie,4.0,38,20,1718,17,pie,set1,3,3,False,1.6438561897747246,8,0,start0,aligned
21,study7Pie,4.0,39,22,1719,20,pie,set3,2,2,False,1.0874628412503393,5,2,non-aligned,non-aligned
21,study7Pie,2.0,40,48,1720,48,pie,set2,0,0,True,-3.0,2,0,start0,aligned
21,study7Pie,4.0,41,13,1721,13,pie,set2,0,0,True,-3.0,12,0,start0,aligned
21,study7Pie,3.0,42,44,1722,43,pie,set3,1,1,False,0.16992500144231237,7,3,non-aligned,non-aligned
21,study7Pie,3.0,43,24,1723,22,pie,set1,2,2,False,1.0874628412503393,3,0,start0,aligned
21,study7Pie,3.0,44,42,1724,43,pie,set2,-1,1,False,0.16992500144231237,7,0,start0,aligned
21,study7Pie,4.0,45,23,1725,16,pie,set1,7,7,False,2.8328900141647417,9,1,non-aligned,non-aligned
21,study7Pie,3.0,46,30,1726,30,pie,set2,0,0,True,-3.0,5,4,non-aligned,non-aligned
21,study7Pie,3.0,47,27,1727,28,pie,set4,-1,1,False,0.16992500144231237,3,0,start0,aligned
21,study7Pie,3.0,48,14,1728,11,pie,set2,3,3,False,1.6438561897747246,11,2,non-aligned,non-aligned
21,study7Pie,3.0,49,15,1729,12,pie,set2,3,3,False,1.6438561897747246,12,1,non-aligned,non-aligned
21,study7Pie,3.0,50,41,1730,41,pie,set1,0,0,True,-3.0,9,0,start0,aligned
21,study7Pie,3.0,51,35,1731,35,pie,set1,0,0,True,-3.0,10,0,start0,aligned
21,study7Pie,3.0,52,19,1732,13,pie,set1,6,6,False,2.6147098441152083,12,6,non-aligned,non-aligned
21,study7Pie,3.0,53,40,1733,40,pie,set2,0,0,True,-3.0,10,1,non-aligned,non-aligned
21,study7Pie,3.0,54,22,1734,19,pie,set1,3,3,False,1.6438561897747246,6,8,non-aligned,non-aligned
21,study7Pie,2.0,55,13,1735,12,pie,set3,1,1,False,0.16992500144231237,12,0,start0,aligned
21,study7Pie,4.0,56,24,1736,22,pie,set4,2,2,False,1.0874628412503393,3,0,start75,aligned
21,study7Pie,3.0,57,29,1737,26,pie,set2,3,3,False,1.6438561897747246,1,10,non-aligned,non-aligned
21,study7Pie,3.0,58,31,1738,34,pie,set3,-3,3,False,1.6438561897747246,9,3,non-aligned,non-aligned
21,study7Pie,2.0,59,48,1739,47,pie,set3,1,1,False,0.16992500144231237,3,10,non-aligned,non-aligned
21,study7Pie,3.0,60,39,1740,39,pie,set1,0,0,True,-3.0,11,4,non-aligned,non-aligned
21,study7Pie,2.0,61,24,1741,24,pie,set1,0,0,True,-3.0,1,0,start0,aligned
21,study7Pie,2.0,62,12,1742,11,pie,set1,1,1,False,0.16992500144231237,11,0,start0,aligned
21,study7Pie,3.0,63,27,1743,24,pie,set3,3,3,False,1.6438561897747246,1,8,non-aligned,non-aligned
21,study7Pie,2.0,64,23,1744,18,pie,set1,5,5,False,2.357552004618084,7,0,start0,aligned
21,study7Pie,3.0,65,46,1745,44,pie,set3,2,2,False,1.0874628412503393,6,0,start0,aligned
21,study7Pie,2.0,66,48,1746,48,pie,set4,0,0,True,-3.0,2,2,non-aligned,non-aligned
21,study7Pie,2.0,67,21,1747,17,pie,set3,4,4,False,2.0443941193584534,8,3,non-aligned,non-aligned
21,study7Pie,4.0,68,38,1748,39,pie,set1,-1,1,False,0.16992500144231237,11,0,start0,aligned
21,study7Pie,3.0,69,26,1749,28,pie,set1,-2,2,False,1.0874628412503393,3,10,non-aligned,non-aligned
21,study7Pie,3.0,70,24,1750,23,pie,set2,1,1,False,0.16992500144231237,2,0,start0,aligned
21,study7Pie,2.0,71,18,1751,15,pie,set2,3,3,False,1.6438561897747246,10,4,non-aligned,non-aligned
21,study7Pie,3.0,72,34,1752,36,pie,set4,-2,2,False,1.0874628412503393,11,0,start0,aligned
21,study7Pie,3.0,73,37,1753,38,pie,set2,-1,1,False,0.16992500144231237,12,0,start0,aligned
21,study7Pie,3.0,74,30,1754,32,pie,set1,-2,2,False,1.0874628412503393,7,0,start0,aligned
21,study7Pie,3.0,75,23,1755,18,pie,set2,5,5,False,2.357552004618084,7,1,non-aligned,non-aligned
21,study7Pie,2.0,76,31,1756,31,pie,set3,0,0,True,-3.0,6,2,non-aligned,non-aligned
21,study7Pie,3.0,77,39,1757,35,pie,set1,4,4,False,2.0443941193584534,10,6,non-aligned,non-aligned
21,study7Pie,3.0,78,28,1758,29,pie,set4,-1,1,False,0.16992500144231237,4,0,start0,aligned
21,study7Pie,2.0,79,21,1759,21,pie,set2,0,0,True,-3.0,4,6,non-aligned,non-aligned
38,study7Pie,27.0,0,20,3040,17,pie,set2,3,3,False,1.6438561897747246,8,5,non-aligned,non-aligned
38,study7Pie,30.0,1,40,3041,39,pie,set1,1,1,False,0.16992500144231237,11,4,non-aligned,non-aligned
38,study7Pie,9.0,2,30,3042,29,pie,set2,1,1,False,0.16992500144231237,4,2,non-aligned,non-aligned
38,study7Pie,17.0,3,45,3043,42,pie,set2,3,3,False,1.6438561897747246,8,0,start0,aligned
38,study7Pie,7.0,4,50,3044,50,pie,set4,0,0,True,-3.0,0,0,start0,aligned
38,study7Pie,6.0,5,20,3045,15,pie,set4,5,5,False,2.357552004618084,10,0,start0,aligned
38,study7Pie,10.0,6,35,3046,34,pie,set1,1,1,False,0.16992500144231237,9,6,non-aligned,non-aligned
38,study7Pie,10.0,7,40,3047,42,pie,set3,-2,2,False,1.0874628412503393,8,7,non-aligned,non-aligned
38,study7Pie,13.0,8,25,3048,25,pie,set2,0,0,True,-3.0,0,8,non-aligned,non-aligned
38,study7Pie,9.0,9,20,3049,15,pie,set2,5,5,False,2.357552004618084,10,4,non-aligned,non-aligned
38,study7Pie,18.0,10,15,3050,13,pie,set3,2,2,False,1.0874628412503393,12,2,non-aligned,non-aligned
38,study7Pie,16.0,11,25,3051,30,pie,set4,-5,5,False,2.357552004618084,5,1,non-aligned,non-aligned
38,study7Pie,10.0,12,45,3052,45,pie,set3,0,0,True,-3.0,5,0,start0,aligned
38,study7Pie,23.0,13,20,3053,14,pie,set4,6,6,False,2.6147098441152083,11,6,non-aligned,non-aligned
38,study7Pie,13.0,14,35,3054,35,pie,set3,0,0,True,-3.0,10,0,start0,aligned
38,study7Pie,8.0,15,25,3055,30,pie,set3,-5,5,False,2.357552004618084,5,0,start0,aligned
38,study7Pie,20.0,16,20,3056,18,pie,set2,2,2,False,1.0874628412503393,7,0,start0,aligned
38,study7Pie,9.0,17,20,3057,19,pie,set2,1,1,False,0.16992500144231237,6,0,start0,aligned
38,study7Pie,18.0,18,35,3058,33,pie,set3,2,2,False,1.0874628412503393,8,3,non-aligned,non-aligned
38,study7Pie,9.0,19,25,3059,31,pie,set1,-6,6,False,2.6147098441152083,6,4,non-aligned,non-aligned
38,study7Pie,5.0,20,40,3060,44,pie,set1,-4,4,False,2.0443941193584534,6,0,start0,aligned
38,study7Pie,9.0,21,20,3061,22,pie,set3,-2,2,False,1.0874628412503393,3,2,non-aligned,non-aligned
38,study7Pie,6.0,22,25,3062,29,pie,set3,-4,4,False,2.0443941193584534,4,0,start0,aligned
38,study7Pie,13.0,23,20,3063,16,pie,set3,4,4,False,2.0443941193584534,9,0,start0,aligned
38,study7Pie,10.0,24,25,3064,23,pie,set3,2,2,False,1.0874628412503393,2,10,non-aligned,non-aligned
38,study7Pie,13.0,25,20,3065,16,pie,set1,4,4,False,2.0443941193584534,9,1,non-aligned,non-aligned
38,study7Pie,6.0,26,25,3066,28,pie,set2,-3,3,False,1.6438561897747246,3,8,non-aligned,non-aligned
38,study7Pie,16.0,27,40,3067,43,pie,set2,-3,3,False,1.6438561897747246,7,0,start0,aligned
38,study7Pie,4.0,28,20,3068,14,pie,set2,6,6,False,2.6147098441152083,11,0,start0,aligned
38,study7Pie,4.0,29,15,3069,11,pie,set3,4,4,False,2.0443941193584534,11,5,non-aligned,non-aligned
38,study7Pie,7.0,30,30,3070,37,pie,set3,-7,7,False,2.8328900141647417,12,0,start0,aligned
38,study7Pie,9.0,31,40,3071,38,pie,set1,2,2,False,1.0874628412503393,12,1,non-aligned,non-aligned
38,study7Pie,6.0,32,45,3072,48,pie,set1,-3,3,False,1.6438561897747246,2,0,start0,aligned
38,study7Pie,6.0,33,45,3073,45,pie,set3,0,0,True,-3.0,5,7,non-aligned,non-aligned
38,study7Pie,7.0,34,35,3074,39,pie,set1,-4,4,False,2.0443941193584534,11,0,start0,aligned
38,study7Pie,5.0,35,35,3075,41,pie,set1,-6,6,False,2.6147098441152083,9,6,non-aligned,non-aligned
38,study7Pie,5.0,36,50,3076,50,pie,set2,0,0,True,-3.0,0,4,non-aligned,non-aligned
38,study7Pie,8.0,37,49,3077,49,pie,set2,0,0,True,-3.0,1,0,start0,aligned
38,study7Pie,10.0,38,45,3078,44,pie,set3,1,1,False,0.16992500144231237,6,8,non-aligned,non-aligned
38,study7Pie,5.0,39,35,3079,41,pie,set1,-6,6,False,2.6147098441152083,9,0,start0,aligned
38,study7Pie,9.0,40,28,3080,21,pie,set4,7,7,False,2.8328900141647417,4,2,non-aligned,non-aligned
38,study7Pie,6.0,41,45,3081,46,pie,set3,-1,1,False,0.16992500144231237,4,10,non-aligned,non-aligned
38,study7Pie,7.0,42,25,3082,27,pie,set1,-2,2,False,1.0874628412503393,2,2,non-aligned,non-aligned
38,study7Pie,6.0,43,45,3083,43,pie,set1,2,2,False,1.0874628412503393,7,2,non-aligned,non-aligned
38,study7Pie,7.0,44,20,3084,12,pie,set3,8,8,False,3.0223678130284544,12,0,start0,aligned
38,study7Pie,9.0,45,48,3085,49,pie,set2,-1,1,False,0.16992500144231237,1,8,non-aligned,non-aligned
38,study7Pie,8.0,46,20,3086,18,pie,set1,2,2,False,1.0874628412503393,7,1,non-aligned,non-aligned
38,study7Pie,5.0,47,25,3087,24,pie,set3,1,1,False,0.16992500144231237,1,0,start0,aligned
38,study7Pie,5.0,48,25,3088,26,pie,set4,-1,1,False,0.16992500144231237,1,0,start0,aligned
38,study7Pie,8.0,49,45,3089,47,pie,set1,-2,2,False,1.0874628412503393,3,2,non-aligned,non-aligned
38,study7Pie,8.0,50,30,3090,36,pie,set4,-6,6,False,2.6147098441152083,11,3,non-aligned,non-aligned
38,study7Pie,28.0,51,35,3091,33,pie,set4,2,2,False,1.0874628412503393,8,0,start0,aligned
38,study7Pie,9.0,52,45,3092,47,pie,set3,-2,2,False,1.0874628412503393,3,0,start0,aligned
38,study7Pie,10.0,53,25,3093,31,pie,set3,-6,6,False,2.6147098441152083,6,0,start0,aligned
38,study7Pie,13.0,54,20,3094,12,pie,set3,8,8,False,3.0223678130284544,12,1,non-aligned,non-aligned
38,study7Pie,8.0,55,30,3095,36,pie,set1,-6,6,False,2.6147098441152083,11,0,start0,aligned
38,study7Pie,7.0,56,35,3096,40,pie,set2,-5,5,False,2.357552004618084,10,1,non-aligned,non-aligned
38,study7Pie,8.0,57,20,3097,13,pie,set1,7,7,False,2.8328900141647417,12,0,start0,aligned
38,study7Pie,22.0,58,35,3098,34,pie,set4,1,1,False,0.16992500144231237,9,0,start0,aligned
38,study7Pie,12.0,59,40,3099,37,pie,set3,3,3,False,1.6438561897747246,12,0,start25,aligned
38,study7Pie,5.0,60,25,3100,21,pie,set2,4,4,False,2.0443941193584534,4,0,start0,aligned
38,study7Pie,7.0,61,20,3101,17,pie,set2,3,3,False,1.6438561897747246,8,0,start0,aligned
38,study7Pie,6.0,62,25,3102,24,pie,set3,1,1,False,0.16992500144231237,1,8,non-aligned,non-aligned
38,study7Pie,6.0,63,35,3103,38,pie,set3,-3,3,False,1.6438561897747246,12,0,start0,aligned
38,study7Pie,6.0,64,15,3104,11,pie,set1,4,4,False,2.0443941193584534,11,0,start0,aligned
38,study7Pie,7.0,65,45,3105,46,pie,set2,-1,1,False,0.16992500144231237,4,0,start0,aligned
38,study7Pie,12.0,66,28,3106,28,pie,set1,0,0,True,-3.0,3,0,start0,aligned
38,study7Pie,15.0,67,20,3107,20,pie,set2,0,0,True,-3.0,5,0,start0,aligned
38,study7Pie,16.0,68,35,3108,35,pie,set3,0,0,True,-3.0,10,2,non-aligned,non-aligned
38,study7Pie,4.0,69,25,3109,25,pie,set4,0,0,True,-3.0,0,0,start0,aligned
38,study7Pie,8.0,70,35,3110,40,pie,set4,-5,5,False,2.357552004618084,10,0,start0,aligned
38,study7Pie,11.0,71,35,3111,32,pie,set3,3,3,False,1.6438561897747246,7,2,non-aligned,non-aligned
38,study7Pie,10.0,72,25,3112,22,pie,set1,3,3,False,1.6438561897747246,3,0,start0,aligned
38,study7Pie,11.0,73,23,3113,19,pie,set3,4,4,False,2.0443941193584534,6,1,non-aligned,non-aligned
38,study7Pie,7.0,74,25,3114,27,pie,set1,-2,2,False,1.0874628412503393,2,0,start0,aligned
38,study7Pie,8.0,75,47,3115,48,pie,set3,-1,1,False,0.16992500144231237,2,2,non-aligned,non-aligned
38,study7Pie,9.0,76,25,3116,26,pie,set2,-1,1,False,0.16992500144231237,1,10,non-aligned,non-aligned
38,study7Pie,8.0,77,25,3117,20,pie,set4,5,5,False,2.357552004618084,5,5,non-aligned,non-aligned
38,study7Pie,8.0,78,25,3118,23,pie,set1,2,2,False,1.0874628412503393,2,0,start0,aligned
38,study7Pie,10.0,79,30,3119,32,pie,set2,-2,2,False,1.0874628412503393,7,0,start0,aligned
31,study7Pie,16.0,0,20,2480,15,pie,set4,5,5,False,2.357552004618084,10,0,start0,aligned
31,study7Pie,14.0,1,20,2481,20,pie,set1,0,0,True,-3.0,5,0,start75,aligned
31,study7Pie,16.0,2,30,2482,31,pie,set1,-1,1,False,0.16992500144231237,6,4,non-aligned,non-aligned
31,study7Pie,12.0,3,20,2483,20,pie,set4,0,0,True,-3.0,5,0,start0,aligned
31,study7Pie,15.0,4,46,2484,44,pie,set4,2,2,False,1.0874628412503393,6,0,start0,aligned
31,study7Pie,7.0,5,46,2485,45,pie,set3,1,1,False,0.16992500144231237,5,7,non-aligned,non-aligned
31,study7Pie,7.0,6,48,2486,46,pie,set3,2,2,False,1.0874628412503393,4,0,start0,aligned
31,study7Pie,8.0,7,17,2487,13,pie,set4,4,4,False,2.0443941193584534,12,0,start0,aligned
31,study7Pie,11.0,8,33,2488,37,pie,set3,-4,4,False,2.0443941193584534,12,0,start0,aligned
31,study7Pie,8.0,9,33,2489,34,pie,set1,-1,1,False,0.16992500144231237,9,6,non-aligned,non-aligned
31,study7Pie,13.0,10,50,2490,50,pie,set3,0,0,True,-3.0,0,5,non-aligned,non-aligned
31,study7Pie,9.0,11,16,2491,17,pie,set4,-1,1,False,0.16992500144231237,8,1,non-aligned,non-aligned
31,study7Pie,10.0,12,15,2492,14,pie,set2,1,1,False,0.16992500144231237,11,4,non-aligned,non-aligned
31,study7Pie,12.0,13,17,2493,17,pie,set2,0,0,True,-3.0,8,0,start0,aligned
31,study7Pie,11.0,14,13,2494,12,pie,set1,1,1,False,0.16992500144231237,12,1,non-aligned,non-aligned
31,study7Pie,6.0,15,45,2495,44,pie,set4,1,1,False,0.16992500144231237,6,2,non-aligned,non-aligned
31,study7Pie,14.0,16,17,2496,19,pie,set2,-2,2,False,1.0874628412503393,6,0,start0,aligned
31,study7Pie,11.0,17,20,2497,21,pie,set1,-1,1,False,0.16992500144231237,4,0,start0,aligned
31,study7Pie,9.0,18,10,2498,11,pie,set1,-1,1,False,0.16992500144231237,11,0,start0,aligned
31,study7Pie,7.0,19,27,2499,27,pie,set2,0,0,True,-3.0,2,0,start0,aligned
31,study7Pie,13.0,20,12,2500,11,pie,set1,1,1,False,0.16992500144231237,11,4,non-aligned,non-aligned
31,study7Pie,7.0,21,34,2501,36,pie,set4,-2,2,False,1.0874628412503393,11,0,start0,aligned
31,study7Pie,9.0,22,12,2502,14,pie,set3,-2,2,False,1.0874628412503393,11,0,start0,aligned
31,study7Pie,7.0,23,22,2503,23,pie,set3,-1,1,False,0.16992500144231237,2,0,start0,aligned
31,study7Pie,7.0,24,35,2504,36,pie,set3,-1,1,False,0.16992500144231237,11,3,non-aligned,non-aligned
31,study7Pie,13.0,25,30,2505,33,pie,set3,-3,3,False,1.6438561897747246,8,0,start0,aligned
31,study7Pie,9.0,26,13,2506,15,pie,set2,-2,2,False,1.0874628412503393,10,4,non-aligned,non-aligned
31,study7Pie,11.0,27,40,2507,38,pie,set1,2,2,False,1.0874628412503393,12,1,non-aligned,non-aligned
31,study7Pie,21.0,28,25,2508,27,pie,set4,-2,2,False,1.0874628412503393,2,3,non-aligned,non-aligned
31,study7Pie,5.0,29,48,2509,49,pie,set3,-1,1,False,0.16992500144231237,1,1,non-aligned,non-aligned
31,study7Pie,11.0,30,30,2510,33,pie,set4,-3,3,False,1.6438561897747246,8,4,non-aligned,non-aligned
31,study7Pie,8.0,31,25,2511,26,pie,set1,-1,1,False,0.16992500144231237,1,0,start0,aligned
31,study7Pie,8.0,32,48,2512,46,pie,set3,2,2,False,1.0874628412503393,4,10,non-aligned,non-aligned
31,study7Pie,11.0,33,30,2513,31,pie,set4,-1,1,False,0.16992500144231237,6,0,start0,aligned
31,study7Pie,7.0,34,45,2514,42,pie,set2,3,3,False,1.6438561897747246,8,0,start0,aligned
31,study7Pie,6.0,35,50,2515,49,pie,set4,1,1,False,0.16992500144231237,1,0,start0,aligned
31,study7Pie,6.0,36,25,2516,26,pie,set2,-1,1,False,0.16992500144231237,1,10,non-aligned,non-aligned
31,study7Pie,13.0,37,43,2517,40,pie,set4,3,3,False,1.6438561897747246,10,2,non-aligned,non-aligned
31,study7Pie,5.0,38,47,2518,43,pie,set2,4,4,False,2.0443941193584534,7,2,non-aligned,non-aligned
31,study7Pie,6.0,39,49,2519,48,pie,set1,1,1,False,0.16992500144231237,2,9,non-aligned,non-aligned
31,study7Pie,8.0,40,27,2520,28,pie,set4,-1,1,False,0.16992500144231237,3,0,start0,aligned
31,study7Pie,5.0,41,49,2521,47,pie,set1,2,2,False,1.0874628412503393,3,2,non-aligned,non-aligned
31,study7Pie,6.0,42,10,2522,16,pie,set2,-6,6,False,2.6147098441152083,9,2,non-aligned,non-aligned
31,study7Pie,7.0,43,37,2523,39,pie,set3,-2,2,False,1.0874628412503393,11,0,start0,aligned
31,study7Pie,10.0,44,23,2524,22,pie,set1,1,1,False,0.16992500144231237,3,0,start0,aligned
31,study7Pie,8.0,45,33,2525,35,pie,set4,-2,2,False,1.0874628412503393,10,0,start0,aligned
31,study7Pie,8.0,46,22,2526,21,pie,set1,1,1,False,0.16992500144231237,4,1,non-aligned,non-aligned
31,study7Pie,5.0,47,48,2527,47,pie,set2,1,1,False,0.16992500144231237,3,0,start0,aligned
31,study7Pie,6.0,48,25,2528,24,pie,set3,1,1,False,0.16992500144231237,1,8,non-aligned,non-aligned
31,study7Pie,5.0,49,22,2529,22,pie,set4,0,0,True,-3.0,3,0,start75,aligned
31,study7Pie,5.0,50,28,2530,30,pie,set1,-2,2,False,1.0874628412503393,5,8,non-aligned,non-aligned
31,study7Pie,7.0,51,11,2531,13,pie,set1,-2,2,False,1.0874628412503393,12,6,non-aligned,non-aligned
31,study7Pie,10.0,52,13,2532,18,pie,set3,-5,5,False,2.357552004618084,7,2,non-aligned,non-aligned
31,study7Pie,8.0,53,18,2533,19,pie,set2,-1,1,False,0.16992500144231237,6,2,non-aligned,non-aligned
31,study7Pie,8.0,54,36,2534,41,pie,set1,-5,5,False,2.357552004618084,9,0,start0,aligned
31,study7Pie,8.0,55,38,2535,41,pie,set1,-3,3,False,1.6438561897747246,9,6,non-aligned,non-aligned
31,study7Pie,9.0,56,33,2536,29,pie,set4,4,4,False,2.0443941193584534,4,0,start0,aligned
31,study7Pie,5.0,57,50,2537,50,pie,set3,0,0,True,-3.0,0,0,start0,aligned
31,study7Pie,6.0,58,48,2538,48,pie,set4,0,0,True,-3.0,2,0,start0,aligned
31,study7Pie,10.0,59,45,2539,39,pie,set1,6,6,False,2.6147098441152083,11,4,non-aligned,non-aligned
31,study7Pie,4.0,60,45,2540,42,pie,set3,3,3,False,1.6438561897747246,8,7,non-aligned,non-aligned
31,study7Pie,8.0,61,38,2541,35,pie,set4,3,3,False,1.6438561897747246,10,0,end100,aligned
31,study7Pie,5.0,62,23,2542,23,pie,set1,0,0,True,-3.0,2,3,non-aligned,non-aligned
31,study7Pie,9.0,63,13,2543,12,pie,set1,1,1,False,0.16992500144231237,12,0,start0,aligned
31,study7Pie,8.0,64,37,2544,38,pie,set1,-1,1,False,0.16992500144231237,12,0,start0,aligned
31,study7Pie,7.0,65,22,2545,24,pie,set1,-2,2,False,1.0874628412503393,1,0,start0,aligned
31,study7Pie,10.0,66,28,2546,32,pie,set2,-4,4,False,2.0443941193584534,7,0,start0,aligned
31,study7Pie,6.0,67,28,2547,32,pie,set2,-4,4,False,2.0443941193584534,7,6,non-aligned,non-aligned
31,study7Pie,6.0,68,26,2548,29,pie,set4,-3,3,False,1.6438561897747246,4,3,non-aligned,non-aligned
31,study7Pie,6.0,69,47,2549,45,pie,set3,2,2,False,1.0874628412503393,5,0,start0,aligned
31,study7Pie,5.0,70,20,2550,16,pie,set1,4,4,False,2.0443941193584534,9,0,start0,aligned
31,study7Pie,7.0,71,40,2551,40,pie,set3,0,0,True,-3.0,10,0,start0,aligned
31,study7Pie,5.0,72,25,2552,25,pie,set3,0,0,True,-3.0,0,5,non-aligned,non-aligned
31,study7Pie,6.0,73,20,2553,18,pie,set1,2,2,False,1.0874628412503393,7,0,start0,aligned
31,study7Pie,6.0,74,40,2554,43,pie,set1,-3,3,False,1.6438561897747246,7,0,start0,aligned
31,study7Pie,5.0,75,25,2555,28,pie,set3,-3,3,False,1.6438561897747246,3,9,non-aligned,non-aligned
31,study7Pie,6.0,76,30,2556,37,pie,set1,-7,7,False,2.8328900141647417,12,6,non-aligned,non-aligned
31,study7Pie,7.0,77,33,2557,34,pie,set3,-1,1,False,0.16992500144231237,9,0,start0,aligned
31,study7Pie,7.0,78,30,2558,30,pie,set2,0,0,True,-3.0,5,0,start0,aligned
31,study7Pie,6.0,79,25,2559,25,pie,set1,0,0,True,-3.0,0,0,start0,aligned
16,study7Pie,6.0,0,45,1280,43,pie,set4,2,2,False,1.0874628412503393,7,6,non-aligned,non-aligned
16,study7Pie,5.0,1,20,1281,18,pie,set1,2,2,False,1.0874628412503393,7,1,non-aligned,non-aligned
16,study7Pie,8.0,2,15,1282,17,pie,set1,-2,2,False,1.0874628412503393,8,0,start0,aligned
16,study7Pie,7.0,3,40,1283,39,pie,set4,1,1,False,0.16992500144231237,11,0,start0,aligned
16,study7Pie,7.0,4,33,1284,33,pie,set1,0,0,True,-3.0,8,0,start0,aligned
16,study7Pie,8.0,5,39,1285,37,pie,set1,2,2,False,1.0874628412503393,12,6,non-aligned,non-aligned
16,study7Pie,5.0,6,20,1286,19,pie,set2,1,1,False,0.16992500144231237,6,0,start0,aligned
16,study7Pie,7.0,7,33,1287,35,pie,set2,-2,2,False,1.0874628412503393,10,0,start0,aligned
16,study7Pie,7.0,8,45,1288,46,pie,set1,-1,1,False,0.16992500144231237,4,0,start0,aligned
16,study7Pie,8.0,9,45,1289,44,pie,set4,1,1,False,0.16992500144231237,6,2,non-aligned,non-aligned
16,study7Pie,8.0,10,29,1290,30,pie,set1,-1,1,False,0.16992500144231237,5,0,start0,aligned
16,study7Pie,8.0,11,20,1291,16,pie,set3,4,4,False,2.0443941193584534,9,3,non-aligned,non-aligned
16,study7Pie,8.0,12,40,1292,47,pie,set4,-7,7,False,2.8328900141647417,3,10,non-aligned,non-aligned
16,study7Pie,7.0,13,30,1293,33,pie,set1,-3,3,False,1.6438561897747246,8,6,non-aligned,non-aligned
16,study7Pie,8.0,14,40,1294,41,pie,set2,-1,1,False,0.16992500144231237,9,4,non-aligned,non-aligned
16,study7Pie,6.0,15,30,1295,30,pie,set4,0,0,True,-3.0,5,1,non-aligned,non-aligned
16,study7Pie,12.0,16,45,1296,45,pie,set1,0,0,True,-3.0,5,0,start0,aligned
16,study7Pie,7.0,17,38,1297,40,pie,set3,-2,2,False,1.0874628412503393,10,2,non-aligned,non-aligned
16,study7Pie,6.0,18,44,1298,44,pie,set3,0,0,True,-3.0,6,0,start0,aligned
16,study7Pie,12.0,19,18,1299,17,pie,set4,1,1,False,0.16992500144231237,8,1,non-aligned,non-aligned
16,study7Pie,6.0,20,49,1300,48,pie,set1,1,1,False,0.16992500144231237,2,0,start0,aligned
16,study7Pie,6.0,21,35,1301,35,pie,set1,0,0,True,-3.0,10,6,non-aligned,non-aligned
16,study7Pie,10.0,22,44,1302,47,pie,set4,-3,3,False,1.6438561897747246,3,0,start0,aligned
16,study7Pie,4.0,23,50,1303,50,pie,set4,0,0,True,-3.0,0,0,start0,aligned
16,study7Pie,8.0,24,12,1304,12,pie,set1,0,0,True,-3.0,12,0,start0,aligned
16,study7Pie,6.0,25,33,1305,32,pie,set3,1,1,False,0.16992500144231237,7,2,non-aligned,non-aligned
16,study7Pie,6.0,26,13,1306,15,pie,set3,-2,2,False,1.0874628412503393,10,0,start0,aligned
16,study7Pie,11.0,27,35,1307,36,pie,set3,-1,1,False,0.16992500144231237,11,3,non-aligned,non-aligned
16,study7Pie,20.0,28,20,1308,21,pie,set3,-1,1,False,0.16992500144231237,4,2,non-aligned,non-aligned
16,study7Pie,8.0,29,38,1309,42,pie,set3,-4,4,False,2.0443941193584534,8,7,non-aligned,non-aligned
16,study7Pie,8.0,30,15,1310,15,pie,set4,0,0,True,-3.0,10,4,non-aligned,non-aligned
16,study7Pie,7.0,31,26,1311,26,pie,set3,0,0,True,-3.0,1,0,start0,aligned
16,study7Pie,6.0,32,50,1312,50,pie,set1,0,0,True,-3.0,0,6,non-aligned,non-aligned
16,study7Pie,7.0,33,44,1313,46,pie,set4,-2,2,False,1.0874628412503393,4,2,non-aligned,non-aligned
16,study7Pie,7.0,34,27,1314,27,pie,set2,0,0,True,-3.0,2,0,start0,aligned
16,study7Pie,6.0,35,30,1315,31,pie,set3,-1,1,False,0.16992500144231237,6,0,start0,aligned
16,study7Pie,12.0,36,25,1316,24,pie,set2,1,1,False,0.16992500144231237,1,2,non-aligned,non-aligned
16,study7Pie,10.0,37,28,1317,29,pie,set1,-1,1,False,0.16992500144231237,4,0,start0,aligned
16,study7Pie,11.0,38,41,1318,41,pie,set1,0,0,True,-3.0,9,0,start0,aligned
16,study7Pie,5.0,39,25,1319,23,pie,set3,2,2,False,1.0874628412503393,2,10,non-aligned,non-aligned
16,study7Pie,6.0,40,27,1320,28,pie,set4,-1,1,False,0.16992500144231237,3,5,non-aligned,non-aligned
16,study7Pie,10.0,41,33,1321,34,pie,set4,-1,1,False,0.16992500144231237,9,2,non-aligned,non-aligned
16,study7Pie,6.0,42,26,1322,25,pie,set2,1,1,False,0.16992500144231237,0,8,non-aligned,non-aligned
16,study7Pie,9.0,43,11,1323,11,pie,set2,0,0,True,-3.0,11,2,non-aligned,non-aligned
16,study7Pie,5.0,44,30,1324,32,pie,set2,-2,2,False,1.0874628412503393,7,0,start0,aligned
16,study7Pie,8.0,45,40,1325,40,pie,set4,0,0,True,-3.0,10,0,start0,aligned
16,study7Pie,7.0,46,23,1326,23,pie,set4,0,0,True,-3.0,2,0,start0,aligned
16,study7Pie,7.0,47,22,1327,20,pie,set2,2,2,False,1.0874628412503393,5,0,start75,aligned
16,study7Pie,11.0,48,21,1328,22,pie,set4,-1,1,False,0.16992500144231237,3,0,start0,aligned
16,study7Pie,7.0,49,24,1329,22,pie,set2,2,2,False,1.0874628412503393,3,9,non-aligned,non-aligned
16,study7Pie,12.0,50,41,1330,42,pie,set2,-1,1,False,0.16992500144231237,8,0,start0,aligned
16,study7Pie,20.0,51,23,1331,24,pie,set2,-1,1,False,0.16992500144231237,1,0,start0,aligned
16,study7Pie,10.0,52,10,1332,14,pie,set4,-4,4,False,2.0443941193584534,11,6,non-aligned,non-aligned
16,study7Pie,17.0,53,32,1333,36,pie,set1,-4,4,False,2.0443941193584534,11,0,start0,aligned
16,study7Pie,12.0,54,37,1334,37,pie,set2,0,0,True,-3.0,12,0,start0,aligned
16,study7Pie,10.0,55,13,1335,16,pie,set3,-3,3,False,1.6438561897747246,9,0,start0,aligned
16,study7Pie,10.0,56,49,1336,49,pie,set2,0,0,True,-3.0,1,0,start0,aligned
16,study7Pie,13.0,57,42,1337,43,pie,set2,-1,1,False,0.16992500144231237,7,0,start0,aligned
16,study7Pie,8.0,58,15,1338,14,pie,set1,1,1,False,0.16992500144231237,11,0,start0,aligned
16,study7Pie,9.0,59,39,1339,38,pie,set3,1,1,False,0.16992500144231237,12,0,start0,aligned
16,study7Pie,5.0,60,40,1340,39,pie,set2,1,1,False,0.16992500144231237,11,1,non-aligned,non-aligned
16,study7Pie,6.0,61,19,1341,18,pie,set1,1,1,False,0.16992500144231237,7,0,start0,aligned
16,study7Pie,7.0,62,49,1342,48,pie,set3,1,1,False,0.16992500144231237,2,2,non-aligned,non-aligned
16,study7Pie,8.0,63,49,1343,49,pie,set4,0,0,True,-3.0,1,5,non-aligned,non-aligned
16,study7Pie,6.0,64,28,1344,31,pie,set1,-3,3,False,1.6438561897747246,6,4,non-aligned,non-aligned
16,study7Pie,4.0,65,10,1345,11,pie,set2,-1,1,False,0.16992500144231237,11,0,start0,aligned
16,study7Pie,5.0,66,25,1346,25,pie,set4,0,0,True,-3.0,0,0,start0,aligned
16,study7Pie,10.0,67,12,1347,13,pie,set2,-1,1,False,0.16992500144231237,12,6,non-aligned,non-aligned
16,study7Pie,5.0,68,20,1348,20,pie,set2,0,0,True,-3.0,5,0,start0,aligned
16,study7Pie,6.0,69,45,1349,45,pie,set1,0,0,True,-3.0,5,2,non-aligned,non-aligned
16,study7Pie,5.0,70,29,1350,29,pie,set2,0,0,True,-3.0,4,2,non-aligned,non-aligned
16,study7Pie,6.0,71,12,1351,12,pie,set2,0,0,True,-3.0,12,1,non-aligned,non-aligned
16,study7Pie,5.0,72,21,1352,21,pie,set4,0,0,True,-3.0,4,0,start0,aligned
16,study7Pie,5.0,73,35,1353,38,pie,set3,-3,3,False,1.6438561897747246,12,3,non-aligned,non-aligned
16,study7Pie,14.0,74,26,1354,26,pie,set4,0,0,True,-3.0,1,1,non-aligned,non-aligned
16,study7Pie,7.0,75,12,1355,13,pie,set1,-1,1,False,0.16992500144231237,12,0,start0,aligned
16,study7Pie,6.0,76,20,1356,19,pie,set2,1,1,False,0.16992500144231237,6,2,non-aligned,non-aligned
16,study7Pie,5.0,77,27,1357,28,pie,set4,-1,1,False,0.16992500144231237,3,0,start0,aligned
16,study7Pie,12.0,78,30,1358,34,pie,set4,-4,4,False,2.0443941193584534,9,0,start0,aligned
16,study7Pie,6.0,79,27,1359,27,pie,set1,0,0,True,-3.0,2,2,non-aligned,non-aligned
24,study7Pie,11.0,0,25,1920,25,pie,set1,0,0,True,-3.0,0,0,start0,aligned
24,study7Pie,8.0,1,30,1921,29,pie,set1,1,1,False,0.16992500144231237,4,2,non-aligned,non-aligned
24,study7Pie,7.0,2,40,1922,35,pie,set1,5,5,False,2.357552004618084,10,6,non-aligned,non-aligned
24,study7Pie,8.0,3,30,1923,31,pie,set2,-1,1,False,0.16992500144231237,6,1,non-aligned,non-aligned
24,study7Pie,9.0,4,20,1924,22,pie,set2,-2,2,False,1.0874628412503393,3,9,non-aligned,non-aligned
24,study7Pie,7.0,5,40,1925,41,pie,set3,-1,1,False,0.16992500144231237,9,1,non-aligned,non-aligned
24,study7Pie,6.0,6,28,1926,25,pie,set2,3,3,False,1.6438561897747246,0,8,non-aligned,non-aligned
24,study7Pie,8.0,7,35,1927,34,pie,set3,1,1,False,0.16992500144231237,9,3,non-aligned,non-aligned
24,study7Pie,10.0,8,17,1928,13,pie,set1,4,4,False,2.0443941193584534,12,0,start0,aligned
24,study7Pie,8.0,9,43,1929,43,pie,set1,0,0,True,-3.0,7,0,start0,aligned
24,study7Pie,6.0,10,27,1930,26,pie,set1,1,1,False,0.16992500144231237,1,0,start0,aligned
24,study7Pie,12.0,11,18,1931,17,pie,set2,1,1,False,0.16992500144231237,8,5,non-aligned,non-aligned
24,study7Pie,7.0,12,48,1932,49,pie,set3,-1,1,False,0.16992500144231237,1,1,non-aligned,non-aligned
24,study7Pie,7.0,13,47,1933,48,pie,set2,-1,1,False,0.16992500144231237,2,0,start0,aligned
24,study7Pie,6.0,14,40,1934,42,pie,set1,-2,2,False,1.0874628412503393,8,0,start0,aligned
24,study7Pie,6.0,15,10,1935,11,pie,set1,-1,1,False,0.16992500144231237,11,4,non-aligned,non-aligned
24,study7Pie,11.0,16,42,1936,45,pie,set2,-3,3,False,1.6438561897747246,5,0,start0,aligned
24,study7Pie,9.0,17,28,1937,27,pie,set4,1,1,False,0.16992500144231237,2,3,non-aligned,non-aligned
24,study7Pie,7.0,18,35,1938,38,pie,set4,-3,3,False,1.6438561897747246,12,0,start0,aligned
24,study7Pie,7.0,19,32,1939,33,pie,set4,-1,1,False,0.16992500144231237,8,0,start0,aligned
24,study7Pie,12.0,20,25,1940,18,pie,set4,7,7,False,2.8328900141647417,7,3,non-aligned,non-aligned
24,study7Pie,10.0,21,18,1941,15,pie,set1,3,3,False,1.6438561897747246,10,5,non-aligned,non-aligned
24,study7Pie,7.0,22,40,1942,37,pie,set3,3,3,False,1.6438561897747246,12,0,start25,aligned
24,study7Pie,8.0,23,44,1943,46,pie,set2,-2,2,False,1.0874628412503393,4,0,start0,aligned
24,study7Pie,7.0,24,30,1944,33,pie,set3,-3,3,False,1.6438561897747246,8,3,non-aligned,non-aligned
24,study7Pie,9.0,25,15,1945,15,pie,set2,0,0,True,-3.0,10,0,start0,aligned
24,study7Pie,7.0,26,42,1946,40,pie,set1,2,2,False,1.0874628412503393,10,6,non-aligned,non-aligned
24,study7Pie,8.0,27,28,1947,29,pie,set1,-1,1,False,0.16992500144231237,4,0,start0,aligned
24,study7Pie,5.0,28,20,1948,20,pie,set1,0,0,True,-3.0,5,0,start75,aligned
24,study7Pie,7.0,29,48,1949,47,pie,set2,1,1,False,0.16992500144231237,3,2,non-aligned,non-aligned
24,study7Pie,6.0,30,40,1950,36,pie,set1,4,4,False,2.0443941193584534,11,0,start0,aligned
24,study7Pie,5.0,31,49,1951,50,pie,set2,-1,1,False,0.16992500144231237,0,4,non-aligned,non-aligned
24,study7Pie,5.0,32,50,1952,50,pie,set3,0,0,True,-3.0,0,0,start0,aligned
24,study7Pie,5.0,33,10,1953,11,pie,set2,-1,1,False,0.16992500144231237,11,0,start0,aligned
24,study7Pie,5.0,34,22,1954,21,pie,set1,1,1,False,0.16992500144231237,4,1,non-aligned,non-aligned
24,study7Pie,5.0,35,30,1955,30,pie,set2,0,0,True,-3.0,5,4,non-aligned,non-aligned
24,study7Pie,7.0,36,32,1956,28,pie,set4,4,4,False,2.0443941193584534,3,0,start0,aligned
24,study7Pie,4.0,37,40,1957,32,pie,set1,8,8,False,3.0223678130284544,7,0,start0,aligned
24,study7Pie,11.0,38,20,1958,20,pie,set4,0,0,True,-3.0,5,0,start0,aligned
24,study7Pie,6.0,39,45,1959,42,pie,set4,3,3,False,1.6438561897747246,8,1,non-aligned,non-aligned
24,study7Pie,8.0,40,40,1960,43,pie,set1,-3,3,False,1.6438561897747246,7,2,non-aligned,non-aligned
24,study7Pie,9.0,41,18,1961,17,pie,set3,1,1,False,0.16992500144231237,8,0,start0,aligned
24,study7Pie,6.0,42,48,1962,48,pie,set2,0,0,True,-3.0,2,2,non-aligned,non-aligned
24,study7Pie,6.0,43,32,1963,34,pie,set3,-2,2,False,1.0874628412503393,9,0,start0,aligned
24,study7Pie,6.0,44,30,1964,38,pie,set4,-8,8,False,3.0223678130284544,12,6,non-aligned,non-aligned
24,study7Pie,9.0,45,20,1965,19,pie,set3,1,1,False,0.16992500144231237,6,0,start0,aligned
24,study7Pie,8.0,46,40,1966,44,pie,set1,-4,4,False,2.0443941193584534,6,2,non-aligned,non-aligned
24,study7Pie,6.0,47,25,1967,28,pie,set3,-3,3,False,1.6438561897747246,3,9,non-aligned,non-aligned
24,study7Pie,8.0,48,35,1968,35,pie,set4,0,0,True,-3.0,10,0,start0,aligned
24,study7Pie,8.0,49,35,1969,37,pie,set3,-2,2,False,1.0874628412503393,12,0,start0,aligned
24,study7Pie,5.0,50,20,1970,23,pie,set2,-3,3,False,1.6438561897747246,2,5,non-aligned,non-aligned
24,study7Pie,8.0,51,42,1971,44,pie,set2,-2,2,False,1.0874628412503393,6,0,start0,aligned
24,study7Pie,5.0,52,30,1972,30,pie,set1,0,0,True,-3.0,5,0,start0,aligned
24,study7Pie,5.0,53,10,1973,12,pie,set4,-2,2,False,1.0874628412503393,12,0,start0,aligned
24,study7Pie,8.0,54,40,1974,36,pie,set4,4,4,False,2.0443941193584534,11,3,non-aligned,non-aligned
24,study7Pie,6.0,55,45,1975,46,pie,set2,-1,1,False,0.16992500144231237,4,9,non-aligned,non-aligned
24,study7Pie,11.0,56,14,1976,16,pie,set1,-2,2,False,1.0874628412503393,9,1,non-aligned,non-aligned
24,study7Pie,7.0,57,40,1977,39,pie,set2,1,1,False,0.16992500144231237,11,1,non-aligned,non-aligned
24,study7Pie,7.0,58,20,1978,18,pie,set1,2,2,False,1.0874628412503393,7,0,start0,aligned
24,study7Pie,9.0,59,22,1979,24,pie,set3,-2,2,False,1.0874628412503393,1,0,start0,aligned
24,study7Pie,7.0,60,13,1980,14,pie,set1,-1,1,False,0.16992500144231237,11,5,non-aligned,non-aligned
24,study7Pie,8.0,61,18,1981,21,pie,set2,-3,3,False,1.6438561897747246,4,0,start0,aligned
24,study7Pie,6.0,62,23,1982,23,pie,set4,0,0,True,-3.0,2,0,start0,aligned
24,study7Pie,7.0,63,40,1983,39,pie,set4,1,1,False,0.16992500144231237,11,0,start0,aligned
24,study7Pie,4.0,64,25,1984,26,pie,set4,-1,1,False,0.16992500144231237,1,1,non-aligned,non-aligned
24,study7Pie,9.0,65,35,1985,41,pie,set2,-6,6,False,2.6147098441152083,9,0,start0,aligned
24,study7Pie,10.0,66,18,1986,16,pie,set3,2,2,False,1.0874628412503393,9,0,start0,aligned
24,study7Pie,8.0,67,30,1987,31,pie,set4,-1,1,False,0.16992500144231237,6,0,start0,aligned
24,study7Pie,6.0,68,20,1988,22,pie,set4,-2,2,False,1.0874628412503393,3,0,start0,aligned
24,study7Pie,6.0,69,15,1989,14,pie,set3,1,1,False,0.16992500144231237,11,0,start0,aligned
24,study7Pie,6.0,70,35,1990,32,pie,set3,3,3,False,1.6438561897747246,7,2,non-aligned,non-aligned
24,study7Pie,6.0,71,40,1991,45,pie,set2,-5,5,False,2.357552004618084,5,9,non-aligned,non-aligned
24,study7Pie,11.0,72,40,1992,40,pie,set3,0,0,True,-3.0,10,0,start0,aligned
24,study7Pie,5.0,73,10,1993,12,pie,set4,-2,2,False,1.0874628412503393,12,6,non-aligned,non-aligned
24,study7Pie,5.0,74,28,1994,27,pie,set4,1,1,False,0.16992500144231237,2,0,start0,aligned
24,study7Pie,8.0,75,46,1995,47,pie,set2,-1,1,False,0.16992500144231237,3,0,start0,aligned
24,study7Pie,7.0,76,12,1996,13,pie,set2,-1,1,False,0.16992500144231237,12,6,non-aligned,non-aligned
24,study7Pie,8.0,77,20,1997,19,pie,set3,1,1,False,0.16992500144231237,6,1,non-aligned,non-aligned
24,study7Pie,5.0,78,49,1998,49,pie,set2,0,0,True,-3.0,1,0,start0,aligned
24,study7Pie,6.0,79,24,1999,24,pie,set1,0,0,True,-3.0,1,5,non-aligned,non-aligned
2,study7Pie,13.0,0,35,160,36,pie,set3,-1,1,False,0.16992500144231237,11,3,non-aligned,non-aligned
2,study7Pie,6.0,1,36,161,29,pie,set4,7,7,False,2.8328900141647417,4,0,start0,aligned
2,study7Pie,6.0,2,22,162,20,pie,set1,2,2,False,1.0874628412503393,5,0,start0,aligned
2,study7Pie,6.0,3,46,163,47,pie,set1,-1,1,False,0.16992500144231237,3,0,start0,aligned
2,study7Pie,8.0,4,35,164,25,pie,set1,10,10,False,3.3398500028846247,0,7,non-aligned,non-aligned
2,study7Pie,8.0,5,25,165,17,pie,set3,8,8,False,3.0223678130284544,8,3,non-aligned,non-aligned
2,study7Pie,19.0,6,22,166,22,pie,set4,0,0,True,-3.0,3,0,start75,aligned
2,study7Pie,5.0,7,20,167,22,pie,set1,-2,2,False,1.0874628412503393,3,0,start0,aligned
2,study7Pie,19.0,8,48,168,49,pie,set3,-1,1,False,0.16992500144231237,1,0,start0,aligned
2,study7Pie,8.0,9,30,169,26,pie,set2,4,4,False,2.0443941193584534,1,10,non-aligned,non-aligned
2,study7Pie,14.0,10,42,170,45,pie,set1,-3,3,False,1.6438561897747246,5,0,start0,aligned
2,study7Pie,6.0,11,37,171,34,pie,set3,3,3,False,1.6438561897747246,9,3,non-aligned,non-aligned
2,study7Pie,6.0,12,32,172,35,pie,set2,-3,3,False,1.6438561897747246,10,0,start0,aligned
2,study7Pie,5.0,13,25,173,27,pie,set4,-2,2,False,1.0874628412503393,2,0,start0,aligned
2,study7Pie,5.0,14,28,174,30,pie,set3,-2,2,False,1.0874628412503393,5,0,start0,aligned
2,study7Pie,6.0,15,37,175,39,pie,set2,-2,2,False,1.0874628412503393,11,0,start0,aligned
2,study7Pie,15.0,16,38,176,42,pie,set4,-4,4,False,2.0443941193584534,8,1,non-aligned,non-aligned
2,study7Pie,7.0,17,15,177,16,pie,set3,-1,1,False,0.16992500144231237,9,0,start0,aligned
2,study7Pie,8.0,18,40,178,42,pie,set3,-2,2,False,1.0874628412503393,8,0,start0,aligned
2,study7Pie,10.0,19,37,179,45,pie,set3,-8,8,False,3.0223678130284544,5,7,non-aligned,non-aligned
2,study7Pie,7.0,20,40,180,50,pie,set1,-10,10,False,3.3398500028846247,0,6,non-aligned,non-aligned
2,study7Pie,7.0,21,36,181,41,pie,set3,-5,5,False,2.357552004618084,9,1,non-aligned,non-aligned
2,study7Pie,7.0,22,35,182,39,pie,set1,-4,4,False,2.0443941193584534,11,4,non-aligned,non-aligned
2,study7Pie,13.0,23,28,183,30,pie,set1,-2,2,False,1.0874628412503393,5,8,non-aligned,non-aligned
2,study7Pie,14.0,24,15,184,13,pie,set4,2,2,False,1.0874628412503393,12,0,start0,aligned
2,study7Pie,7.0,25,23,185,21,pie,set4,2,2,False,1.0874628412503393,4,0,start0,aligned
2,study7Pie,6.0,26,38,186,44,pie,set3,-6,6,False,2.6147098441152083,6,8,non-aligned,non-aligned
2,study7Pie,6.0,27,30,187,33,pie,set4,-3,3,False,1.6438561897747246,8,0,start0,aligned
2,study7Pie,6.0,28,40,188,43,pie,set2,-3,3,False,1.6438561897747246,7,0,start0,aligned
2,study7Pie,6.0,29,15,189,14,pie,set4,1,1,False,0.16992500144231237,11,0,start0,aligned
2,study7Pie,7.0,30,37,190,41,pie,set2,-4,4,False,2.0443941193584534,9,0,start0,aligned
2,study7Pie,8.0,31,35,191,32,pie,set1,3,3,False,1.6438561897747246,7,0,start0,aligned
2,study7Pie,9.0,32,30,192,34,pie,set2,-4,4,False,2.0443941193584534,9,0,start0,aligned
2,study7Pie,10.0,33,40,193,46,pie,set3,-6,6,False,2.6147098441152083,4,10,non-aligned,non-aligned
2,study7Pie,7.0,34,15,194,12,pie,set3,3,3,False,1.6438561897747246,12,0,start0,aligned
2,study7Pie,9.0,35,15,195,12,pie,set2,3,3,False,1.6438561897747246,12,1,non-aligned,non-aligned
2,study7Pie,6.0,36,20,196,19,pie,set2,1,1,False,0.16992500144231237,6,0,start0,aligned
2,study7Pie,7.0,37,49,197,48,pie,set4,1,1,False,0.16992500144231237,2,2,non-aligned,non-aligned
2,study7Pie,4.0,38,20,198,19,pie,set1,1,1,False,0.16992500144231237,6,8,non-aligned,non-aligned
2,study7Pie,6.0,39,25,199,47,pie,set2,-22,22,False,4.467605550082998,3,2,non-aligned,non-aligned
2,study7Pie,7.0,40,43,200,46,pie,set1,-3,3,False,1.6438561897747246,4,0,start0,aligned
2,study7Pie,5.0,41,15,201,11,pie,set2,4,4,False,2.0443941193584534,11,2,non-aligned,non-aligned
2,study7Pie,12.0,42,40,202,38,pie,set3,2,2,False,1.0874628412503393,12,3,non-aligned,non-aligned
2,study7Pie,4.0,43,35,203,31,pie,set3,4,4,False,2.0443941193584534,6,0,start0,aligned
2,study7Pie,5.0,44,35,204,28,pie,set2,7,7,False,2.8328900141647417,3,0,start0,aligned
2,study7Pie,5.0,45,48,205,44,pie,set3,4,4,False,2.0443941193584534,6,0,start0,aligned
2,study7Pie,6.0,46,35,206,24,pie,set2,11,11,False,3.4757334309663976,1,2,non-aligned,non-aligned
2,study7Pie,7.0,47,20,207,13,pie,set2,7,7,False,2.8328900141647417,12,6,non-aligned,non-aligned
2,study7Pie,13.0,48,35,208,43,pie,set1,-8,8,False,3.0223678130284544,7,2,non-aligned,non-aligned
2,study7Pie,6.0,49,25,209,15,pie,set4,10,10,False,3.3398500028846247,10,0,start0,aligned
2,study7Pie,10.0,50,20,210,14,pie,set1,6,6,False,2.6147098441152083,11,5,non-aligned,non-aligned
2,study7Pie,14.0,51,26,211,21,pie,set1,5,5,False,2.357552004618084,4,1,non-aligned,non-aligned
2,study7Pie,5.0,52,40,212,40,pie,set3,0,0,True,-3.0,10,0,start0,aligned
2,study7Pie,4.0,53,35,213,28,pie,set4,7,7,False,2.8328900141647417,3,5,non-aligned,non-aligned
2,study7Pie,4.0,54,30,214,25,pie,set1,5,5,False,2.357552004618084,0,0,start0,aligned
2,study7Pie,7.0,55,25,215,20,pie,set2,5,5,False,2.357552004618084,5,0,start75,aligned
2,study7Pie,6.0,56,50,216,50,pie,set1,0,0,True,-3.0,0,0,start0,aligned
2,study7Pie,5.0,57,25,217,18,pie,set4,7,7,False,2.8328900141647417,7,0,start0,aligned
2,study7Pie,8.0,58,30,218,32,pie,set4,-2,2,False,1.0874628412503393,7,7,non-aligned,non-aligned
2,study7Pie,10.0,59,30,219,35,pie,set4,-5,5,False,2.357552004618084,10,0,end100,aligned
2,study7Pie,5.0,60,25,220,23,pie,set4,2,2,False,1.0874628412503393,2,10,non-aligned,non-aligned
2,study7Pie,6.0,61,35,221,37,pie,set3,-2,2,False,1.0874628412503393,12,0,start25,aligned
2,study7Pie,5.0,62,25,222,26,pie,set3,-1,1,False,0.16992500144231237,1,0,start0,aligned
2,study7Pie,5.0,63,30,223,36,pie,set3,-6,6,False,2.6147098441152083,11,0,start0,aligned
2,study7Pie,9.0,64,30,224,29,pie,set4,1,1,False,0.16992500144231237,4,3,non-aligned,non-aligned
2,study7Pie,5.0,65,25,225,23,pie,set1,2,2,False,1.0874628412503393,2,0,start0,aligned
2,study7Pie,11.0,66,40,226,37,pie,set4,3,3,False,1.6438561897747246,12,0,start0,aligned
2,study7Pie,5.0,67,35,227,33,pie,set1,2,2,False,1.0874628412503393,8,6,non-aligned,non-aligned
2,study7Pie,6.0,68,23,228,17,pie,set3,6,6,False,2.6147098441152083,8,0,start0,aligned
2,study7Pie,8.0,69,25,229,27,pie,set1,-2,2,False,1.0874628412503393,2,2,non-aligned,non-aligned
2,study7Pie,8.0,70,25,230,31,pie,set1,-6,6,False,2.6147098441152083,6,4,non-aligned,non-aligned
2,study7Pie,8.0,71,40,231,40,pie,set2,0,0,True,-3.0,10,1,non-aligned,non-aligned
2,study7Pie,24.0,72,20,232,15,pie,set2,5,5,False,2.357552004618084,10,4,non-aligned,non-aligned
2,study7Pie,11.0,73,48,233,49,pie,set3,-1,1,False,0.16992500144231237,1,1,non-aligned,non-aligned
2,study7Pie,4.0,74,35,234,38,pie,set2,-3,3,False,1.6438561897747246,12,0,start0,aligned
2,study7Pie,7.0,75,23,235,16,pie,set2,7,7,False,2.8328900141647417,9,2,non-aligned,non-aligned
2,study7Pie,5.0,76,40,236,48,pie,set4,-8,8,False,3.0223678130284544,2,0,start0,aligned
2,study7Pie,5.0,77,25,237,24,pie,set2,1,1,False,0.16992500144231237,1,0,start0,aligned
2,study7Pie,6.0,78,20,238,18,pie,set3,2,2,False,1.0874628412503393,7,2,non-aligned,non-aligned
2,study7Pie,4.0,79,15,239,11,pie,set1,4,4,False,2.0443941193584534,11,0,start0,aligned
26,study7Pie,49.0,0,70,2080,22,pie,set4,48,48,False,5.588714635582264,3,0,start0,aligned
26,study7Pie,18.0,1,90,2081,26,pie,set3,64,64,False,6.002815015607054,1,0,start0,aligned
26,study7Pie,13.0,2,100,2082,27,pie,set4,73,73,False,6.1922928144707665,2,0,start0,aligned
26,study7Pie,39.0,3,46,2083,47,pie,set3,-1,1,False,0.16992500144231237,3,0,start0,aligned
26,study7Pie,13.0,4,30,2084,33,pie,set4,-3,3,False,1.6438561897747246,8,4,non-aligned,non-aligned
26,study7Pie,11.0,5,48,2085,49,pie,set1,-1,1,False,0.16992500144231237,1,0,start0,aligned
26,study7Pie,10.0,6,33,2086,35,pie,set4,-2,2,False,1.0874628412503393,10,0,end100,aligned
26,study7Pie,10.0,7,48,2087,46,pie,set2,2,2,False,1.0874628412503393,4,0,start0,aligned
26,study7Pie,23.0,8,40,2088,34,pie,set2,6,6,False,2.6147098441152083,9,2,non-aligned,non-aligned
26,study7Pie,9.0,9,15,2089,13,pie,set4,2,2,False,1.0874628412503393,12,6,non-aligned,non-aligned
26,study7Pie,46.0,10,48,2090,47,pie,set4,1,1,False,0.16992500144231237,3,10,non-aligned,non-aligned
26,study7Pie,10.0,11,25,2091,29,pie,set1,-4,4,False,2.0443941193584534,4,2,non-aligned,non-aligned
26,study7Pie,7.0,12,45,2092,45,pie,set1,0,0,True,-3.0,5,2,non-aligned,non-aligned
26,study7Pie,17.0,13,20,2093,23,pie,set4,-3,3,False,1.6438561897747246,2,0,start0,aligned
26,study7Pie,12.0,14,35,2094,32,pie,set1,3,3,False,1.6438561897747246,7,0,start0,aligned
26,study7Pie,8.0,15,48,2095,49,pie,set3,-1,1,False,0.16992500144231237,1,1,non-aligned,non-aligned
26,study7Pie,17.0,16,25,2096,24,pie,set1,1,1,False,0.16992500144231237,1,0,start0,aligned
26,study7Pie,16.0,17,15,2097,15,pie,set1,0,0,True,-3.0,10,0,start0,aligned
26,study7Pie,9.0,18,40,2098,37,pie,set4,3,3,False,1.6438561897747246,12,1,non-aligned,non-aligned
26,study7Pie,15.0,19,24,2099,29,pie,set2,-5,5,False,2.357552004618084,4,0,start0,aligned
26,study7Pie,11.0,20,45,2100,43,pie,set2,2,2,False,1.0874628412503393,7,2,non-aligned,non-aligned
26,study7Pie,11.0,21,45,2101,40,pie,set1,5,5,False,2.357552004618084,10,6,non-aligned,non-aligned
26,study7Pie,7.0,22,45,2102,40,pie,set4,5,5,False,2.357552004618084,10,0,start0,aligned
26,study7Pie,9.0,23,47,2103,46,pie,set1,1,1,False,0.16992500144231237,4,6,non-aligned,non-aligned
26,study7Pie,10.0,24,40,2104,35,pie,set2,5,5,False,2.357552004618084,10,0,start0,aligned
26,study7Pie,8.0,25,15,2105,13,pie,set3,2,2,False,1.0874628412503393,12,0,start0,aligned
26,study7Pie,24.0,26,35,2106,36,pie,set2,-1,1,False,0.16992500144231237,11,1,non-aligned,non-aligned
26,study7Pie,9.0,27,45,2107,45,pie,set2,0,0,True,-3.0,5,0,start0,aligned
26,study7Pie,10.0,28,50,2108,50,pie,set3,0,0,True,-3.0,0,5,non-aligned,non-aligned
26,study7Pie,11.0,29,20,2109,18,pie,set1,2,2,False,1.0874628412503393,7,1,non-aligned,non-aligned
26,study7Pie,17.0,30,38,2110,38,pie,set1,0,0,True,-3.0,12,0,start0,aligned
26,study7Pie,9.0,31,45,2111,43,pie,set1,2,2,False,1.0874628412503393,7,0,start0,aligned
26,study7Pie,11.0,32,25,2112,27,pie,set1,-2,2,False,1.0874628412503393,2,2,non-aligned,non-aligned
26,study7Pie,11.0,33,35,2113,37,pie,set3,-2,2,False,1.0874628412503393,12,0,start0,aligned
26,study7Pie,13.0,34,30,2114,30,pie,set4,0,0,True,-3.0,5,0,start0,aligned
26,study7Pie,10.0,35,48,2115,48,pie,set3,0,0,True,-3.0,2,2,non-aligned,non-aligned
26,study7Pie,31.0,36,30,2116,30,pie,set2,0,0,True,-3.0,5,4,non-aligned,non-aligned
26,study7Pie,20.0,37,15,2117,15,pie,set3,0,0,True,-3.0,10,3,non-aligned,non-aligned
26,study7Pie,6.0,38,15,2118,12,pie,set2,3,3,False,1.6438561897747246,12,0,start0,aligned
26,study7Pie,17.0,39,35,2119,32,pie,set3,3,3,False,1.6438561897747246,7,2,non-aligned,non-aligned
26,study7Pie,14.0,40,20,2120,17,pie,set4,3,3,False,1.6438561897747246,8,1,non-aligned,non-aligned
26,study7Pie,15.0,41,30,2121,31,pie,set1,-1,1,False,0.16992500144231237,6,0,start0,aligned
26,study7Pie,12.0,42,40,2122,42,pie,set3,-2,2,False,1.0874628412503393,8,0,start0,aligned
26,study7Pie,28.0,43,23,2123,25,pie,set1,-2,2,False,1.0874628412503393,0,0,start0,aligned
26,study7Pie,13.0,44,20,2124,20,pie,set3,0,0,True,-3.0,5,2,non-aligned,non-aligned
26,study7Pie,11.0,45,20,2125,24,pie,set3,-4,4,False,2.0443941193584534,1,8,non-aligned,non-aligned
26,study7Pie,18.0,46,44,2126,41,pie,set2,3,3,False,1.6438561897747246,9,0,start0,aligned
26,study7Pie,28.0,47,14,2127,11,pie,set3,3,3,False,1.6438561897747246,11,0,start0,aligned
26,study7Pie,20.0,48,20,2128,14,pie,set1,6,6,False,2.6147098441152083,11,0,start0,aligned
26,study7Pie,17.0,49,15,2129,12,pie,set4,3,3,False,1.6438561897747246,12,6,non-aligned,non-aligned
26,study7Pie,13.0,50,30,2130,33,pie,set4,-3,3,False,1.6438561897747246,8,0,start0,aligned
26,study7Pie,7.0,51,25,2131,26,pie,set2,-1,1,False,0.16992500144231237,1,10,non-aligned,non-aligned
26,study7Pie,118.0,52,45,2132,44,pie,set2,1,1,False,0.16992500144231237,6,9,non-aligned,non-aligned
26,study7Pie,25.0,53,27,2133,28,pie,set1,-1,1,False,0.16992500144231237,3,10,non-aligned,non-aligned
26,study7Pie,35.0,54,33,2134,31,pie,set1,2,2,False,1.0874628412503393,6,4,non-aligned,non-aligned
26,study7Pie,35.0,55,45,2135,44,pie,set4,1,1,False,0.16992500144231237,6,0,start0,aligned
26,study7Pie,8.0,56,20,2136,18,pie,set1,2,2,False,1.0874628412503393,7,0,start0,aligned
26,study7Pie,17.0,57,22,2137,21,pie,set1,1,1,False,0.16992500144231237,4,0,start0,aligned
26,study7Pie,9.0,58,13,2138,11,pie,set2,2,2,False,1.0874628412503393,11,2,non-aligned,non-aligned
26,study7Pie,59.0,59,18,2139,14,pie,set4,4,4,False,2.0443941193584534,11,6,non-aligned,non-aligned
26,study7Pie,9.0,60,30,2140,28,pie,set2,2,2,False,1.0874628412503393,3,0,start0,aligned
26,study7Pie,15.0,61,17,2141,17,pie,set1,0,0,True,-3.0,8,0,start0,aligned
26,study7Pie,10.0,62,25,2142,22,pie,set3,3,3,False,1.6438561897747246,3,2,non-aligned,non-aligned
26,study7Pie,11.0,63,18,2143,16,pie,set4,2,2,False,1.0874628412503393,9,0,start0,aligned
26,study7Pie,10.0,64,20,2144,20,pie,set1,0,0,True,-3.0,5,0,start0,aligned
26,study7Pie,14.0,65,15,2145,16,pie,set1,-1,1,False,0.16992500144231237,9,1,non-aligned,non-aligned
26,study7Pie,10.0,66,48,2146,48,pie,set1,0,0,True,-3.0,2,0,start0,aligned
26,study7Pie,9.0,67,22,2147,21,pie,set3,1,1,False,0.16992500144231237,4,2,non-aligned,non-aligned
26,study7Pie,11.0,68,20,2148,19,pie,set4,1,1,False,0.16992500144231237,6,0,end75,aligned
26,study7Pie,8.0,69,45,2149,39,pie,set3,6,6,False,2.6147098441152083,11,3,non-aligned,non-aligned
26,study7Pie,8.0,70,35,2150,34,pie,set2,1,1,False,0.16992500144231237,9,0,start0,aligned
26,study7Pie,7.0,71,45,2151,42,pie,set4,3,3,False,1.6438561897747246,8,1,non-aligned,non-aligned
26,study7Pie,7.0,72,45,2152,38,pie,set2,7,7,False,2.8328900141647417,12,5,non-aligned,non-aligned
26,study7Pie,5.0,73,50,2153,50,pie,set2,0,0,True,-3.0,0,0,start0,aligned
26,study7Pie,10.0,74,20,2154,19,pie,set4,1,1,False,0.16992500144231237,6,0,start0,aligned
26,study7Pie,11.0,75,25,2155,25,pie,set4,0,0,True,-3.0,0,0,start25,aligned
26,study7Pie,7.0,76,25,2156,23,pie,set2,2,2,False,1.0874628412503393,2,5,non-aligned,non-aligned
26,study7Pie,20.0,77,40,2157,41,pie,set2,-1,1,False,0.16992500144231237,9,4,non-aligned,non-aligned
26,study7Pie,7.0,78,42,2158,36,pie,set2,6,6,False,2.6147098441152083,11,0,start0,aligned
26,study7Pie,8.0,79,45,2159,39,pie,set3,6,6,False,2.6147098441152083,11,0,start0,aligned
36,study7Pie,36.0,0,40,2880,43,pie,set1,-3,3,False,1.6438561897747246,7,2,non-aligned,non-aligned
36,study7Pie,9.0,1,45,2881,47,pie,set4,-2,2,False,1.0874628412503393,3,0,start0,aligned
36,study7Pie,7.0,2,20,2882,12,pie,set4,8,8,False,3.0223678130284544,12,0,start0,aligned
36,study7Pie,9.0,3,40,2883,41,pie,set3,-1,1,False,0.16992500144231237,9,0,start0,aligned
36,study7Pie,8.0,4,49,2884,47,pie,set3,2,2,False,1.0874628412503393,3,10,non-aligned,non-aligned
36,study7Pie,12.0,5,25,2885,23,pie,set4,2,2,False,1.0874628412503393,2,10,non-aligned,non-aligned
36,study7Pie,12.0,6,25,2886,19,pie,set3,6,6,False,2.6147098441152083,6,0,start0,aligned
36,study7Pie,8.0,7,35,2887,32,pie,set3,3,3,False,1.6438561897747246,7,0,start0,aligned
36,study7Pie,5.0,8,40,2888,35,pie,set3,5,5,False,2.357552004618084,10,2,non-aligned,non-aligned
36,study7Pie,10.0,9,30,2889,20,pie,set1,10,10,False,3.3398500028846247,5,0,start0,aligned
36,study7Pie,19.0,10,35,2890,24,pie,set3,11,11,False,3.4757334309663976,1,8,non-aligned,non-aligned
36,study7Pie,11.0,11,35,2891,18,pie,set2,17,17,False,4.098032082960526,7,0,start0,aligned
36,study7Pie,13.0,12,15,2892,13,pie,set1,2,2,False,1.0874628412503393,12,0,start0,aligned
36,study7Pie,7.0,13,45,2893,26,pie,set2,19,19,False,4.257387842692652,1,0,start0,aligned
36,study7Pie,8.0,14,48,2894,42,pie,set1,6,6,False,2.6147098441152083,8,0,start0,aligned
36,study7Pie,12.0,15,40,2895,40,pie,set4,0,0,True,-3.0,10,2,non-aligned,non-aligned
36,study7Pie,10.0,16,15,2896,11,pie,set1,4,4,False,2.0443941193584534,11,4,non-aligned,non-aligned
36,study7Pie,12.0,17,35,2897,34,pie,set2,1,1,False,0.16992500144231237,9,2,non-aligned,non-aligned
36,study7Pie,10.0,18,40,2898,36,pie,set3,4,4,False,2.0443941193584534,11,0,start0,aligned
36,study7Pie,8.0,19,40,2899,40,pie,set4,0,0,True,-3.0,10,0,start0,aligned
36,study7Pie,9.0,20,30,2900,29,pie,set1,1,1,False,0.16992500144231237,4,2,non-aligned,non-aligned
36,study7Pie,6.0,21,30,2901,35,pie,set4,-5,5,False,2.357552004618084,10,0,start0,aligned
36,study7Pie,13.0,22,20,2902,24,pie,set1,-4,4,False,2.0443941193584534,1,0,start0,aligned
36,study7Pie,22.0,23,45,2903,44,pie,set2,1,1,False,0.16992500144231237,6,9,non-aligned,non-aligned
36,study7Pie,6.0,24,30,2904,28,pie,set1,2,2,False,1.0874628412503393,3,0,start0,aligned
36,study7Pie,7.0,25,20,2905,13,pie,set3,7,7,False,2.8328900141647417,12,2,non-aligned,non-aligned
36,study7Pie,8.0,26,60,2906,33,pie,set1,27,27,False,4.7615512324444795,8,0,start0,aligned
36,study7Pie,13.0,27,70,2907,45,pie,set3,25,25,False,4.651051691178929,5,0,start0,aligned
36,study7Pie,17.0,28,40,2908,38,pie,set1,2,2,False,1.0874628412503393,12,0,start0,aligned
36,study7Pie,9.0,29,40,2909,31,pie,set4,9,9,False,3.189824558880017,6,0,end50,aligned
36,study7Pie,8.0,30,40,2910,43,pie,set1,-3,3,False,1.6438561897747246,7,0,start0,aligned
36,study7Pie,8.0,31,40,2911,34,pie,set4,6,6,False,2.6147098441152083,9,0,start0,aligned
36,study7Pie,6.0,32,45,2912,39,pie,set3,6,6,False,2.6147098441152083,11,3,non-aligned,non-aligned
36,study7Pie,7.0,33,49,2913,49,pie,set4,0,0,True,-3.0,1,5,non-aligned,non-aligned
36,study7Pie,8.0,34,25,2914,21,pie,set2,4,4,False,2.0443941193584534,4,6,non-aligned,non-aligned
36,study7Pie,18.0,35,35,2915,30,pie,set2,5,5,False,2.357552004618084,5,0,start0,aligned
36,study7Pie,9.0,36,48,2916,46,pie,set1,2,2,False,1.0874628412503393,4,6,non-aligned,non-aligned
36,study7Pie,10.0,37,45,2917,46,pie,set3,-1,1,False,0.16992500144231237,4,0,start0,aligned
36,study7Pie,6.0,38,49,2918,49,pie,set3,0,0,True,-3.0,1,0,start0,aligned
36,study7Pie,13.0,39,20,2919,16,pie,set3,4,4,False,2.0443941193584534,9,0,start0,aligned
36,study7Pie,12.0,40,30,2920,31,pie,set4,-1,1,False,0.16992500144231237,6,0,start0,aligned
36,study7Pie,19.0,41,35,2921,33,pie,set4,2,2,False,1.0874628412503393,8,4,non-aligned,non-aligned
36,study7Pie,20.0,42,25,2922,23,pie,set1,2,2,False,1.0874628412503393,2,0,start0,aligned
36,study7Pie,14.0,43,48,2923,48,pie,set1,0,0,True,-3.0,2,9,non-aligned,non-aligned
36,study7Pie,14.0,44,20,2924,22,pie,set3,-2,2,False,1.0874628412503393,3,2,non-aligned,non-aligned
36,study7Pie,9.0,45,15,2925,15,pie,set4,0,0,True,-3.0,10,0,start0,aligned
36,study7Pie,6.0,46,15,2926,15,pie,set4,0,0,True,-3.0,10,4,non-aligned,non-aligned
36,study7Pie,9.0,47,35,2927,37,pie,set2,-2,2,False,1.0874628412503393,12,0,start0,aligned
36,study7Pie,14.0,48,40,2928,38,pie,set1,2,2,False,1.0874628412503393,12,1,non-aligned,non-aligned
36,study7Pie,7.0,49,15,2929,12,pie,set4,3,3,False,1.6438561897747246,12,6,non-aligned,non-aligned
36,study7Pie,11.0,50,20,2930,17,pie,set2,3,3,False,1.6438561897747246,8,0,start0,aligned
36,study7Pie,8.0,51,45,2931,44,pie,set2,1,1,False,0.16992500144231237,6,0,start0,aligned
36,study7Pie,7.0,52,30,2932,29,pie,set2,1,1,False,0.16992500144231237,4,0,start0,aligned
36,study7Pie,6.0,53,30,2933,25,pie,set3,5,5,False,2.357552004618084,0,5,non-aligned,non-aligned
36,study7Pie,7.0,54,40,2934,41,pie,set3,-1,1,False,0.16992500144231237,9,1,non-aligned,non-aligned
36,study7Pie,19.0,55,15,2935,14,pie,set3,1,1,False,0.16992500144231237,11,2,non-aligned,non-aligned
36,study7Pie,6.0,56,35,2936,39,pie,set4,-4,4,False,2.0443941193584534,11,0,start0,aligned
36,study7Pie,8.0,57,47,2937,48,pie,set3,-1,1,False,0.16992500144231237,2,0,start0,aligned
36,study7Pie,5.0,58,45,2938,42,pie,set4,3,3,False,1.6438561897747246,8,1,non-aligned,non-aligned
36,study7Pie,6.0,59,20,2939,22,pie,set3,-2,2,False,1.0874628412503393,3,0,start0,aligned
36,study7Pie,7.0,60,30,2940,32,pie,set1,-2,2,False,1.0874628412503393,7,2,non-aligned,non-aligned
36,study7Pie,10.0,61,20,2941,26,pie,set2,-6,6,False,2.6147098441152083,1,10,non-aligned,non-aligned
36,study7Pie,7.0,62,52,2942,50,pie,set1,2,2,False,1.0874628412503393,0,0,start0,aligned
36,study7Pie,7.0,63,20,2943,21,pie,set3,-1,1,False,0.16992500144231237,4,0,start0,aligned
36,study7Pie,7.0,64,35,2944,28,pie,set2,7,7,False,2.8328900141647417,3,8,non-aligned,non-aligned
36,study7Pie,15.0,65,30,2945,20,pie,set1,10,10,False,3.3398500028846247,5,0,start75,aligned
36,study7Pie,7.0,66,45,2946,45,pie,set1,0,0,True,-3.0,5,2,non-aligned,non-aligned
36,study7Pie,10.0,67,30,2947,27,pie,set2,3,3,False,1.6438561897747246,2,0,start0,aligned
36,study7Pie,5.0,68,25,2948,25,pie,set2,0,0,True,-3.0,0,0,start0,aligned
36,study7Pie,8.0,69,20,2949,27,pie,set3,-7,7,False,2.8328900141647417,2,6,non-aligned,non-aligned
36,study7Pie,14.0,70,15,2950,16,pie,set2,-1,1,False,0.16992500144231237,9,2,non-aligned,non-aligned
36,study7Pie,5.0,71,50,2951,50,pie,set1,0,0,True,-3.0,0,6,non-aligned,non-aligned
36,study7Pie,13.0,72,35,2952,36,pie,set4,-1,1,False,0.16992500144231237,11,3,non-aligned,non-aligned
36,study7Pie,9.0,73,30,2953,30,pie,set1,0,0,True,-3.0,5,8,non-aligned,non-aligned
36,study7Pie,8.0,74,20,2954,19,pie,set1,1,1,False,0.16992500144231237,6,8,non-aligned,non-aligned
36,study7Pie,7.0,75,15,2955,18,pie,set3,-3,3,False,1.6438561897747246,7,2,non-aligned,non-aligned
36,study7Pie,7.0,76,15,2956,14,pie,set4,1,1,False,0.16992500144231237,11,0,start0,aligned
36,study7Pie,7.0,77,35,2957,37,pie,set3,-2,2,False,1.0874628412503393,12,0,start25,aligned
36,study7Pie,9.0,78,20,2958,17,pie,set4,3,3,False,1.6438561897747246,8,1,non-aligned,non-aligned
36,study7Pie,8.0,79,15,2959,11,pie,set2,4,4,False,2.0443941193584534,11,0,start0,aligned
18,study7Pie,43.0,0,32,1440,36,pie,set4,-4,4,False,2.0443941193584534,11,3,non-aligned,non-aligned
18,study7Pie,30.0,1,13,1441,14,pie,set1,-1,1,False,0.16992500144231237,11,0,start0,aligned
18,study7Pie,18.0,2,40,1442,39,pie,set1,1,1,False,0.16992500144231237,11,0,start0,aligned
18,study7Pie,25.0,3,40,1443,39,pie,set4,1,1,False,0.16992500144231237,11,1,non-aligned,non-aligned
18,study7Pie,12.0,4,41,1444,36,pie,set2,5,5,False,2.357552004618084,11,0,start0,aligned
18,study7Pie,41.0,5,20,1445,16,pie,set2,4,4,False,2.0443941193584534,9,2,non-aligned,non-aligned
18,study7Pie,13.0,6,35,1446,33,pie,set2,2,2,False,1.0874628412503393,8,0,start0,aligned
18,study7Pie,16.0,7,39,1447,41,pie,set1,-2,2,False,1.0874628412503393,9,6,non-aligned,non-aligned
18,study7Pie,15.0,8,20,1448,15,pie,set4,5,5,False,2.357552004618084,10,0,start0,aligned
18,study7Pie,11.0,9,33,1449,29,pie,set4,4,4,False,2.0443941193584534,4,3,non-aligned,non-aligned
18,study7Pie,8.0,10,45,1450,45,pie,set1,0,0,True,-3.0,5,2,non-aligned,non-aligned
18,study7Pie,12.0,11,32,1451,26,pie,set3,6,6,False,2.6147098441152083,1,0,start0,aligned
18,study7Pie,9.0,12,12,1452,12,pie,set1,0,0,True,-3.0,12,0,start0,aligned
18,study7Pie,11.0,13,21,1453,14,pie,set1,7,7,False,2.8328900141647417,11,5,non-aligned,non-aligned
18,study7Pie,10.0,14,30,1454,34,pie,set4,-4,4,False,2.0443941193584534,9,2,non-aligned,non-aligned
18,study7Pie,8.0,15,13,1455,12,pie,set1,1,1,False,0.16992500144231237,12,1,non-aligned,non-aligned
18,study7Pie,10.0,16,42,1456,32,pie,set2,10,10,False,3.3398500028846247,7,0,start0,aligned
18,study7Pie,14.0,17,31,1457,32,pie,set2,-1,1,False,0.16992500144231237,7,6,non-aligned,non-aligned
18,study7Pie,12.0,18,29,1458,21,pie,set3,8,8,False,3.0223678130284544,4,0,start0,aligned
18,study7Pie,13.0,19,22,1459,16,pie,set3,6,6,False,2.6147098441152083,9,0,start0,aligned
18,study7Pie,13.0,20,24,1460,17,pie,set2,7,7,False,2.8328900141647417,8,5,non-aligned,non-aligned
18,study7Pie,13.0,21,26,1461,25,pie,set2,1,1,False,0.16992500144231237,0,8,non-aligned,non-aligned
18,study7Pie,10.0,22,48,1462,46,pie,set2,2,2,False,1.0874628412503393,4,0,start0,aligned
18,study7Pie,7.0,23,28,1463,25,pie,set3,3,3,False,1.6438561897747246,0,0,start0,aligned
18,study7Pie,8.0,24,50,1464,50,pie,set3,0,0,True,-3.0,0,0,start0,aligned
18,study7Pie,25.0,25,40,1465,33,pie,set4,7,7,False,2.8328900141647417,8,4,non-aligned,non-aligned
18,study7Pie,10.0,26,44,1466,47,pie,set1,-3,3,False,1.6438561897747246,3,2,non-aligned,non-aligned
18,study7Pie,12.0,27,43,1467,40,pie,set1,3,3,False,1.6438561897747246,10,6,non-aligned,non-aligned
18,study7Pie,11.0,28,44,1468,37,pie,set2,7,7,False,2.8328900141647417,12,5,non-aligned,non-aligned
18,study7Pie,13.0,29,36,1469,31,pie,set1,5,5,False,2.357552004618084,6,0,start0,aligned
18,study7Pie,16.0,30,27,1470,27,pie,set1,0,0,True,-3.0,2,2,non-aligned,non-aligned
18,study7Pie,8.0,31,45,1471,45,pie,set1,0,0,True,-3.0,5,0,start0,aligned
18,study7Pie,8.0,32,44,1472,47,pie,set4,-3,3,False,1.6438561897747246,3,0,start0,aligned
18,study7Pie,8.0,33,25,1473,15,pie,set1,10,10,False,3.3398500028846247,10,5,non-aligned,non-aligned
18,study7Pie,13.0,34,42,1474,38,pie,set2,4,4,False,2.0443941193584534,12,0,start0,aligned
18,study7Pie,11.0,35,24,1475,22,pie,set4,2,2,False,1.0874628412503393,3,0,start75,aligned
18,study7Pie,10.0,36,47,1476,48,pie,set3,-1,1,False,0.16992500144231237,2,0,start0,aligned
18,study7Pie,9.0,37,33,1477,34,pie,set1,-1,1,False,0.16992500144231237,9,0,start0,aligned
18,study7Pie,41.0,38,32,1478,40,pie,set2,-8,8,False,3.0223678130284544,10,0,start0,aligned
18,study7Pie,9.0,39,34,1479,35,pie,set4,-1,1,False,0.16992500144231237,10,0,start0,aligned
18,study7Pie,12.0,40,40,1480,46,pie,set1,-6,6,False,2.6147098441152083,4,6,non-aligned,non-aligned
18,study7Pie,12.0,41,48,1481,48,pie,set2,0,0,True,-3.0,2,2,non-aligned,non-aligned
18,study7Pie,10.0,42,42,1482,43,pie,set1,-1,1,False,0.16992500144231237,7,2,non-aligned,non-aligned
18,study7Pie,16.0,43,37,1483,35,pie,set4,2,2,False,1.0874628412503393,10,0,end100,aligned
18,study7Pie,10.0,44,41,1484,44,pie,set4,-3,3,False,1.6438561897747246,6,0,start0,aligned
18,study7Pie,13.0,45,29,1485,29,pie,set1,0,0,True,-3.0,4,0,start0,aligned
18,study7Pie,10.0,46,24,1486,22,pie,set4,2,2,False,1.0874628412503393,3,0,start0,aligned
18,study7Pie,14.0,47,23,1487,17,pie,set4,6,6,False,2.6147098441152083,8,0,start0,aligned
18,study7Pie,9.0,48,20,1488,13,pie,set2,7,7,False,2.8328900141647417,12,6,non-aligned,non-aligned
18,study7Pie,11.0,49,29,1489,27,pie,set4,2,2,False,1.0874628412503393,2,0,start0,aligned
18,study7Pie,11.0,50,28,1490,21,pie,set1,7,7,False,2.8328900141647417,4,1,non-aligned,non-aligned
18,study7Pie,14.0,51,44,1491,41,pie,set4,3,3,False,1.6438561897747246,9,0,start0,aligned
18,study7Pie,10.0,52,40,1492,44,pie,set2,-4,4,False,2.0443941193584534,6,9,non-aligned,non-aligned
18,study7Pie,10.0,53,41,1493,42,pie,set4,-1,1,False,0.16992500144231237,8,1,non-aligned,non-aligned
18,study7Pie,8.0,54,26,1494,20,pie,set2,6,6,False,2.6147098441152083,5,0,start75,aligned
18,study7Pie,8.0,55,28,1495,28,pie,set2,0,0,True,-3.0,3,8,non-aligned,non-aligned
18,study7Pie,15.0,56,26,1496,23,pie,set2,3,3,False,1.6438561897747246,2,0,start0,aligned
18,study7Pie,7.0,57,24,1497,19,pie,set4,5,5,False,2.357552004618084,6,0,start0,aligned
18,study7Pie,13.0,58,42,1498,42,pie,set2,0,0,True,-3.0,8,0,start0,aligned
18,study7Pie,8.0,59,49,1499,49,pie,set2,0,0,True,-3.0,1,8,non-aligned,non-aligned
18,study7Pie,12.0,60,28,1500,20,pie,set3,8,8,False,3.0223678130284544,5,0,start0,aligned
18,study7Pie,9.0,61,33,1501,28,pie,set4,5,5,False,2.357552004618084,3,0,start0,aligned
18,study7Pie,14.0,62,22,1502,18,pie,set4,4,4,False,2.0443941193584534,7,0,start0,aligned
18,study7Pie,11.0,63,30,1503,23,pie,set2,7,7,False,2.8328900141647417,2,5,non-aligned,non-aligned
18,study7Pie,11.0,64,13,1504,11,pie,set3,2,2,False,1.0874628412503393,11,0,start0,aligned
18,study7Pie,12.0,65,24,1505,24,pie,set4,0,0,True,-3.0,1,0,start0,aligned
18,study7Pie,10.0,66,30,1506,30,pie,set2,0,0,True,-3.0,5,4,non-aligned,non-aligned
18,study7Pie,11.0,67,14,1507,11,pie,set2,3,3,False,1.6438561897747246,11,2,non-aligned,non-aligned
18,study7Pie,8.0,68,39,1508,43,pie,set1,-4,4,False,2.0443941193584534,7,0,start0,aligned
18,study7Pie,8.0,69,50,1509,50,pie,set2,0,0,True,-3.0,0,4,non-aligned,non-aligned
18,study7Pie,10.0,70,39,1510,37,pie,set4,2,2,False,1.0874628412503393,12,0,start0,aligned
18,study7Pie,18.0,71,18,1511,13,pie,set4,5,5,False,2.357552004618084,12,0,start0,aligned
18,study7Pie,13.0,72,30,1512,24,pie,set4,6,6,False,2.6147098441152083,1,9,non-aligned,non-aligned
18,study7Pie,9.0,73,26,1513,26,pie,set2,0,0,True,-3.0,1,10,non-aligned,non-aligned
18,study7Pie,20.0,74,38,1514,30,pie,set4,8,8,False,3.0223678130284544,5,0,start0,aligned
18,study7Pie,9.0,75,28,1515,31,pie,set1,-3,3,False,1.6438561897747246,6,4,non-aligned,non-aligned
18,study7Pie,9.0,76,22,1516,18,pie,set4,4,4,False,2.0443941193584534,7,3,non-aligned,non-aligned
18,study7Pie,7.0,77,23,1517,19,pie,set2,4,4,False,2.0443941193584534,6,2,non-aligned,non-aligned
18,study7Pie,11.0,78,40,1518,38,pie,set2,2,2,False,1.0874628412503393,12,5,non-aligned,non-aligned
18,study7Pie,7.0,79,49,1519,49,pie,set1,0,0,True,-3.0,1,0,start0,aligned
11,study7Pie,11.0,0,20,880,16,pie,set2,4,4,False,2.0443941193584534,9,0,start0,aligned
11,study7Pie,8.0,1,25,881,21,pie,set3,4,4,False,2.0443941193584534,4,2,non-aligned,non-aligned
11,study7Pie,6.0,2,33,882,35,pie,set3,-2,2,False,1.0874628412503393,10,2,non-aligned,non-aligned
11,study7Pie,6.0,3,40,883,42,pie,set1,-2,2,False,1.0874628412503393,8,0,start0,aligned
11,study7Pie,4.0,4,25,884,25,pie,set2,0,0,True,-3.0,0,8,non-aligned,non-aligned
11,study7Pie,5.0,5,20,885,18,pie,set3,2,2,False,1.0874628412503393,7,2,non-aligned,non-aligned
11,study7Pie,5.0,6,33,886,40,pie,set1,-7,7,False,2.8328900141647417,10,0,start0,aligned
11,study7Pie,6.0,7,19,887,17,pie,set4,2,2,False,1.0874628412503393,8,1,non-aligned,non-aligned
11,study7Pie,4.0,8,15,888,11,pie,set3,4,4,False,2.0443941193584534,11,0,start0,aligned
11,study7Pie,7.0,9,45,889,46,pie,set3,-1,1,False,0.16992500144231237,4,10,non-aligned,non-aligned
11,study7Pie,4.0,10,20,890,20,pie,set3,0,0,True,-3.0,5,0,start0,aligned
11,study7Pie,5.0,11,40,891,38,pie,set4,2,2,False,1.0874628412503393,12,6,non-aligned,non-aligned
11,study7Pie,6.0,12,49,892,47,pie,set2,2,2,False,1.0874628412503393,3,2,non-aligned,non-aligned
11,study7Pie,5.0,13,35,893,29,pie,set2,6,6,False,2.6147098441152083,4,2,non-aligned,non-aligned
11,study7Pie,5.0,14,40,894,41,pie,set2,-1,1,False,0.16992500144231237,9,0,start0,aligned
11,study7Pie,4.0,15,25,895,24,pie,set2,1,1,False,0.16992500144231237,1,2,non-aligned,non-aligned
11,study7Pie,5.0,16,38,896,31,pie,set3,7,7,False,2.8328900141647417,6,2,non-aligned,non-aligned
11,study7Pie,5.0,17,40,897,32,pie,set2,8,8,False,3.0223678130284544,7,6,non-aligned,non-aligned
11,study7Pie,4.0,18,24,898,12,pie,set2,12,12,False,3.599912842187128,12,0,start0,aligned
11,study7Pie,3.0,19,28,899,18,pie,set1,10,10,False,3.3398500028846247,7,0,start0,aligned
11,study7Pie,3.0,20,35,900,32,pie,set2,3,3,False,1.6438561897747246,7,0,start0,aligned
11,study7Pie,4.0,21,23,901,22,pie,set4,1,1,False,0.16992500144231237,3,0,start75,aligned
11,study7Pie,3.0,22,22,902,15,pie,set2,7,7,False,2.8328900141647417,10,0,start0,aligned
11,study7Pie,5.0,23,29,903,30,pie,set4,-1,1,False,0.16992500144231237,5,0,start0,aligned
11,study7Pie,5.0,24,18,904,11,pie,set4,7,7,False,2.8328900141647417,11,4,non-aligned,non-aligned
11,study7Pie,4.0,25,20,905,13,pie,set3,7,7,False,2.8328900141647417,12,2,non-aligned,non-aligned
11,study7Pie,6.0,26,38,906,34,pie,set1,4,4,False,2.0443941193584534,9,0,start0,aligned
11,study7Pie,4.0,27,47,907,43,pie,set4,4,4,False,2.0443941193584534,7,6,non-aligned,non-aligned
11,study7Pie,5.0,28,37,908,41,pie,set2,-4,4,False,2.0443941193584534,9,4,non-aligned,non-aligned
11,study7Pie,5.0,29,20,909,17,pie,set1,3,3,False,1.6438561897747246,8,0,start0,aligned
11,study7Pie,4.0,30,40,910,37,pie,set3,3,3,False,1.6438561897747246,12,0,start25,aligned
11,study7Pie,5.0,31,25,911,25,pie,set3,0,0,True,-3.0,0,0,start0,aligned
11,study7Pie,5.0,32,40,912,36,pie,set1,4,4,False,2.0443941193584534,11,3,non-aligned,non-aligned
11,study7Pie,6.0,33,18,913,12,pie,set3,6,6,False,2.6147098441152083,12,1,non-aligned,non-aligned
11,study7Pie,5.0,34,27,914,27,pie,set2,0,0,True,-3.0,2,0,start0,aligned
11,study7Pie,10.0,35,35,915,39,pie,set2,-4,4,False,2.0443941193584534,11,0,start0,aligned
11,study7Pie,12.0,36,38,916,33,pie,set3,5,5,False,2.357552004618084,8,3,non-aligned,non-aligned
11,study7Pie,5.0,37,25,917,22,pie,set1,3,3,False,1.6438561897747246,3,0,start0,aligned
11,study7Pie,19.0,38,35,918,30,pie,set1,5,5,False,2.357552004618084,5,8,non-aligned,non-aligned
11,study7Pie,5.0,39,20,919,14,pie,set3,6,6,False,2.6147098441152083,11,2,non-aligned,non-aligned
11,study7Pie,4.0,40,20,920,15,pie,set4,5,5,False,2.357552004618084,10,4,non-aligned,non-aligned
11,study7Pie,4.0,41,35,921,29,pie,set4,6,6,False,2.6147098441152083,4,0,start0,aligned
11,study7Pie,3.0,42,25,922,28,pie,set2,-3,3,False,1.6438561897747246,3,8,non-aligned,non-aligned
11,study7Pie,4.0,43,38,923,31,pie,set3,7,7,False,2.8328900141647417,6,0,start0,aligned
11,study7Pie,6.0,44,15,924,13,pie,set1,2,2,False,1.0874628412503393,12,0,start0,aligned
11,study7Pie,4.0,45,49,925,49,pie,set1,0,0,True,-3.0,1,0,start0,aligned
11,study7Pie,6.0,46,50,926,49,pie,set2,1,1,False,0.16992500144231237,1,8,non-aligned,non-aligned
11,study7Pie,4.0,47,25,927,23,pie,set2,2,2,False,1.0874628412503393,2,5,non-aligned,non-aligned
11,study7Pie,4.0,48,46,928,45,pie,set3,1,1,False,0.16992500144231237,5,7,non-aligned,non-aligned
11,study7Pie,4.0,49,22,929,19,pie,set1,3,3,False,1.6438561897747246,6,0,start0,aligned
11,study7Pie,3.0,50,35,930,33,pie,set2,2,2,False,1.0874628412503393,8,0,start0,aligned
11,study7Pie,3.0,51,24,931,16,pie,set2,8,8,False,3.0223678130284544,9,2,non-aligned,non-aligned
11,study7Pie,5.0,52,40,932,43,pie,set3,-3,3,False,1.6438561897747246,7,0,start0,aligned
11,study7Pie,7.0,53,40,933,40,pie,set2,0,0,True,-3.0,10,1,non-aligned,non-aligned
11,study7Pie,10.0,54,45,934,45,pie,set3,0,0,True,-3.0,5,0,start0,aligned
11,study7Pie,3.0,55,50,935,50,pie,set1,0,0,True,-3.0,0,6,non-aligned,non-aligned
11,study7Pie,3.0,56,25,936,26,pie,set2,-1,1,False,0.16992500144231237,1,10,non-aligned,non-aligned
11,study7Pie,4.0,57,45,937,48,pie,set2,-3,3,False,1.6438561897747246,2,2,non-aligned,non-aligned
11,study7Pie,4.0,58,46,938,48,pie,set1,-2,2,False,1.0874628412503393,2,0,start0,aligned
11,study7Pie,4.0,59,33,939,35,pie,set4,-2,2,False,1.0874628412503393,10,0,start0,aligned
11,study7Pie,11.0,60,40,940,44,pie,set4,-4,4,False,2.0443941193584534,6,0,start0,aligned
11,study7Pie,8.0,61,35,941,36,pie,set1,-1,1,False,0.16992500144231237,11,0,start0,aligned
11,study7Pie,5.0,62,42,942,47,pie,set1,-5,5,False,2.357552004618084,3,0,start0,aligned
11,study7Pie,5.0,63,28,943,28,pie,set2,0,0,True,-3.0,3,0,start0,aligned
11,study7Pie,13.0,64,43,944,42,pie,set2,1,1,False,0.16992500144231237,8,4,non-aligned,non-aligned
11,study7Pie,36.0,65,28,945,19,pie,set3,9,9,False,3.189824558880017,6,1,non-aligned,non-aligned
11,study7Pie,11.0,66,23,946,21,pie,set4,2,2,False,1.0874628412503393,4,0,start0,aligned
11,study7Pie,21.0,67,32,947,38,pie,set2,-6,6,False,2.6147098441152083,12,0,start0,aligned
11,study7Pie,4.0,68,25,948,27,pie,set1,-2,2,False,1.0874628412503393,2,2,non-aligned,non-aligned
11,study7Pie,6.0,69,40,949,39,pie,set4,1,1,False,0.16992500144231237,11,1,non-aligned,non-aligned
11,study7Pie,3.0,70,40,950,46,pie,set2,-6,6,False,2.6147098441152083,4,0,start0,aligned
11,study7Pie,4.0,71,25,951,26,pie,set4,-1,1,False,0.16992500144231237,1,0,start0,aligned
11,study7Pie,3.0,72,36,952,34,pie,set2,2,2,False,1.0874628412503393,9,2,non-aligned,non-aligned
11,study7Pie,5.0,73,26,953,24,pie,set3,2,2,False,1.0874628412503393,1,0,start0,aligned
11,study7Pie,7.0,74,40,954,44,pie,set3,-4,4,False,2.0443941193584534,6,8,non-aligned,non-aligned
11,study7Pie,6.0,75,22,955,23,pie,set4,-1,1,False,0.16992500144231237,2,0,start0,aligned
11,study7Pie,4.0,76,40,956,37,pie,set2,3,3,False,1.6438561897747246,12,0,start0,aligned
11,study7Pie,3.0,77,25,957,20,pie,set4,5,5,False,2.357552004618084,5,5,non-aligned,non-aligned
11,study7Pie,3.0,78,17,958,14,pie,set1,3,3,False,1.6438561897747246,11,0,start0,aligned
11,study7Pie,4.0,79,50,959,50,pie,set1,0,0,True,-3.0,0,0,start0,aligned
5,study7Pie,44.0,0,13,400,15,pie,set1,-2,2,False,1.0874628412503393,10,0,start0,aligned
5,study7Pie,40.0,1,25,401,22,pie,set2,3,3,False,1.6438561897747246,3,0,start0,aligned
5,study7Pie,54.0,2,47,402,47,pie,set3,0,0,True,-3.0,3,10,non-aligned,non-aligned
5,study7Pie,17.0,3,15,403,13,pie,set3,2,2,False,1.0874628412503393,12,2,non-aligned,non-aligned
5,study7Pie,20.0,4,37,404,40,pie,set1,-3,3,False,1.6438561897747246,10,0,start0,aligned
5,study7Pie,10.0,5,50,405,50,pie,set2,0,0,True,-3.0,0,0,start0,aligned
5,study7Pie,38.0,6,30,406,36,pie,set2,-6,6,False,2.6147098441152083,11,1,non-aligned,non-aligned
5,study7Pie,11.0,7,45,407,42,pie,set4,3,3,False,1.6438561897747246,8,0,start0,aligned
5,study7Pie,13.0,8,40,408,39,pie,set3,1,1,False,0.16992500144231237,11,0,start0,aligned
5,study7Pie,58.0,9,15,409,20,pie,set1,-5,5,False,2.357552004618084,5,0,start75,aligned
5,study7Pie,27.0,10,32,410,30,pie,set2,2,2,False,1.0874628412503393,5,4,non-aligned,non-aligned
5,study7Pie,56.0,11,10,411,11,pie,set4,-1,1,False,0.16992500144231237,11,4,non-aligned,non-aligned
5,study7Pie,35.0,12,49,412,49,pie,set1,0,0,True,-3.0,1,0,start0,aligned
5,study7Pie,22.0,13,35,413,31,pie,set2,4,4,False,2.0443941193584534,6,0,start0,aligned
5,study7Pie,10.0,14,13,414,13,pie,set4,0,0,True,-3.0,12,0,start0,aligned
5,study7Pie,25.0,15,40,415,38,pie,set3,2,2,False,1.0874628412503393,12,3,non-aligned,non-aligned
5,study7Pie,27.0,16,13,416,12,pie,set4,1,1,False,0.16992500144231237,12,6,non-aligned,non-aligned
5,study7Pie,23.0,17,37,417,32,pie,set2,5,5,False,2.357552004618084,7,0,start0,aligned
5,study7Pie,38.0,18,35,418,33,pie,set4,2,2,False,1.0874628412503393,8,0,start0,aligned
5,study7Pie,63.0,19,42,419,40,pie,set2,2,2,False,1.0874628412503393,10,1,non-aligned,non-aligned
5,study7Pie,15.0,20,48,420,49,pie,set2,-1,1,False,0.16992500144231237,1,8,non-aligned,non-aligned
5,study7Pie,10.0,21,37,421,35,pie,set2,2,2,False,1.0874628412503393,10,0,start0,aligned
5,study7Pie,66.0,22,20,422,20,pie,set1,0,0,True,-3.0,5,0,start0,aligned
5,study7Pie,18.0,23,30,423,28,pie,set1,2,2,False,1.0874628412503393,3,0,start0,aligned
5,study7Pie,13.0,24,43,424,44,pie,set2,-1,1,False,0.16992500144231237,6,9,non-aligned,non-aligned
5,study7Pie,10.0,25,14,425,12,pie,set3,2,2,False,1.0874628412503393,12,0,start0,aligned
5,study7Pie,10.0,26,48,426,48,pie,set2,0,0,True,-3.0,2,0,start0,aligned
5,study7Pie,11.0,27,33,427,38,pie,set4,-5,5,False,2.357552004618084,12,0,start0,aligned
5,study7Pie,62.0,28,28,428,31,pie,set1,-3,3,False,1.6438561897747246,6,4,non-aligned,non-aligned
5,study7Pie,10.0,29,25,429,24,pie,set2,1,1,False,0.16992500144231237,1,0,start0,aligned
5,study7Pie,11.0,30,42,430,41,pie,set3,1,1,False,0.16992500144231237,9,1,non-aligned,non-aligned
5,study7Pie,28.0,31,18,431,15,pie,set4,3,3,False,1.6438561897747246,10,4,non-aligned,non-aligned
5,study7Pie,34.0,32,32,432,37,pie,set4,-5,5,False,2.357552004618084,12,1,non-aligned,non-aligned
5,study7Pie,30.0,33,50,433,50,pie,set4,0,0,True,-3.0,0,7,non-aligned,non-aligned
5,study7Pie,6.0,34,25,434,22,pie,set2,3,3,False,1.6438561897747246,3,9,non-aligned,non-aligned
5,study7Pie,14.0,35,48,435,48,pie,set1,0,0,True,-3.0,2,9,non-aligned,non-aligned
5,study7Pie,34.0,36,45,436,43,pie,set4,2,2,False,1.0874628412503393,7,6,non-aligned,non-aligned
5,study7Pie,75.0,37,39,437,39,pie,set2,0,0,True,-3.0,11,1,non-aligned,non-aligned
5,study7Pie,89.0,38,42,438,44,pie,set3,-2,2,False,1.0874628412503393,6,0,start0,aligned
5,study7Pie,7.0,39,25,439,25,pie,set3,0,0,True,-3.0,0,0,start0,aligned
5,study7Pie,14.0,40,30,440,32,pie,set4,-2,2,False,1.0874628412503393,7,7,non-aligned,non-aligned
5,study7Pie,15.0,41,48,441,46,pie,set4,2,2,False,1.0874628412503393,4,0,start0,aligned
5,study7Pie,7.0,42,25,442,21,pie,set4,4,4,False,2.0443941193584534,4,2,non-aligned,non-aligned
5,study7Pie,42.0,43,15,443,16,pie,set1,-1,1,False,0.16992500144231237,9,1,non-aligned,non-aligned
5,study7Pie,47.0,44,30,444,35,pie,set2,-5,5,False,2.357552004618084,10,3,non-aligned,non-aligned
5,study7Pie,40.0,45,20,445,19,pie,set1,1,1,False,0.16992500144231237,6,8,non-aligned,non-aligned
5,study7Pie,25.0,46,48,446,46,pie,set2,2,2,False,1.0874628412503393,4,9,non-aligned,non-aligned
5,study7Pie,22.0,47,47,447,45,pie,set4,2,2,False,1.0874628412503393,5,7,non-aligned,non-aligned
5,study7Pie,13.0,48,35,448,36,pie,set3,-1,1,False,0.16992500144231237,11,0,start0,aligned
5,study7Pie,12.0,49,30,449,29,pie,set3,1,1,False,0.16992500144231237,4,9,non-aligned,non-aligned
5,study7Pie,27.0,50,24,450,24,pie,set1,0,0,True,-3.0,1,5,non-aligned,non-aligned
5,study7Pie,11.0,51,25,451,26,pie,set2,-1,1,False,0.16992500144231237,1,0,start0,aligned
5,study7Pie,44.0,52,42,452,42,pie,set2,0,0,True,-3.0,8,4,non-aligned,non-aligned
5,study7Pie,22.0,53,25,453,28,pie,set4,-3,3,False,1.6438561897747246,3,5,non-aligned,non-aligned
5,study7Pie,40.0,54,25,454,27,pie,set2,-2,2,False,1.0874628412503393,2,0,start0,aligned
5,study7Pie,21.0,55,15,455,18,pie,set1,-3,3,False,1.6438561897747246,7,1,non-aligned,non-aligned
5,study7Pie,24.0,56,30,456,34,pie,set3,-4,4,False,2.0443941193584534,9,0,start0,aligned
5,study7Pie,84.0,57,25,457,23,pie,set3,2,2,False,1.0874628412503393,2,0,start0,aligned
5,study7Pie,27.0,58,25,458,21,pie,set4,4,4,False,2.0443941193584534,4,0,start0,aligned
5,study7Pie,8.0,59,15,459,17,pie,set1,-2,2,False,1.0874628412503393,8,0,start0,aligned
5,study7Pie,8.0,60,13,460,14,pie,set4,-1,1,False,0.16992500144231237,11,0,start0,aligned
5,study7Pie,8.0,61,28,461,29,pie,set3,-1,1,False,0.16992500144231237,4,0,start0,aligned
5,study7Pie,12.0,62,45,462,43,pie,set4,2,2,False,1.0874628412503393,7,0,start0,aligned
5,study7Pie,7.0,63,30,463,30,pie,set2,0,0,True,-3.0,5,0,start0,aligned
5,study7Pie,10.0,64,17,464,19,pie,set3,-2,2,False,1.0874628412503393,6,0,start0,aligned
5,study7Pie,18.0,65,25,465,25,pie,set3,0,0,True,-3.0,0,5,non-aligned,non-aligned
5,study7Pie,8.0,66,35,466,33,pie,set2,2,2,False,1.0874628412503393,8,8,non-aligned,non-aligned
5,study7Pie,14.0,67,44,467,41,pie,set4,3,3,False,1.6438561897747246,9,0,start0,aligned
5,study7Pie,8.0,68,13,468,14,pie,set1,-1,1,False,0.16992500144231237,11,5,non-aligned,non-aligned
5,study7Pie,6.0,69,15,469,18,pie,set1,-3,3,False,1.6438561897747246,7,0,start0,aligned
5,study7Pie,19.0,70,40,470,37,pie,set4,3,3,False,1.6438561897747246,12,0,start0,aligned
5,study7Pie,9.0,71,13,471,11,pie,set4,2,2,False,1.0874628412503393,11,0,start0,aligned
5,study7Pie,19.0,72,35,472,34,pie,set4,1,1,False,0.16992500144231237,9,2,non-aligned,non-aligned
5,study7Pie,26.0,73,48,473,47,pie,set1,1,1,False,0.16992500144231237,3,0,start0,aligned
5,study7Pie,249.0,74,28,474,27,pie,set4,1,1,False,0.16992500144231237,2,3,non-aligned,non-aligned
5,study7Pie,11.0,75,15,475,16,pie,set3,-1,1,False,0.16992500144231237,9,0,start0,aligned
5,study7Pie,26.0,76,47,476,45,pie,set2,2,2,False,1.0874628412503393,5,0,start0,aligned
5,study7Pie,10.0,77,13,477,17,pie,set2,-4,4,False,2.0443941193584534,8,5,non-aligned,non-aligned
5,study7Pie,10.0,78,25,478,26,pie,set4,-1,1,False,0.16992500144231237,1,1,non-aligned,non-aligned
5,study7Pie,24.0,79,20,479,23,pie,set3,-3,3,False,1.6438561897747246,2,10,non-aligned,non-aligned
23,study7Pie,13.0,0,50,1840,50,pie,set3,0,0,True,-3.0,0,5,non-aligned,non-aligned
23,study7Pie,32.0,1,35,1841,27,pie,set1,8,8,False,3.0223678130284544,2,0,start0,aligned
23,study7Pie,13.0,2,30,1842,23,pie,set4,7,7,False,2.8328900141647417,2,0,start0,aligned
23,study7Pie,20.0,3,48,1843,41,pie,set1,7,7,False,2.8328900141647417,9,0,start0,aligned
23,study7Pie,7.0,4,20,1844,13,pie,set1,7,7,False,2.8328900141647417,12,6,non-aligned,non-aligned
23,study7Pie,14.0,5,43,1845,45,pie,set4,-2,2,False,1.0874628412503393,5,7,non-aligned,non-aligned
23,study7Pie,13.0,6,47,1846,36,pie,set4,11,11,False,3.4757334309663976,11,0,start0,aligned
23,study7Pie,7.0,7,15,1847,11,pie,set3,4,4,False,2.0443941193584534,11,5,non-aligned,non-aligned
23,study7Pie,8.0,8,38,1848,35,pie,set2,3,3,False,1.6438561897747246,10,3,non-aligned,non-aligned
23,study7Pie,9.0,9,35,1849,33,pie,set4,2,2,False,1.0874628412503393,8,0,start0,aligned
23,study7Pie,16.0,10,25,1850,25,pie,set1,0,0,True,-3.0,0,7,non-aligned,non-aligned
23,study7Pie,7.0,11,20,1851,21,pie,set3,-1,1,False,0.16992500144231237,4,2,non-aligned,non-aligned
23,study7Pie,10.0,12,48,1852,44,pie,set1,4,4,False,2.0443941193584534,6,0,start0,aligned
23,study7Pie,7.0,13,35,1853,27,pie,set2,8,8,False,3.0223678130284544,2,11,non-aligned,non-aligned
23,study7Pie,6.0,14,20,1854,19,pie,set4,1,1,False,0.16992500144231237,6,0,end75,aligned
23,study7Pie,7.0,15,43,1855,38,pie,set2,5,5,False,2.357552004618084,12,0,start0,aligned
23,study7Pie,8.0,16,40,1856,39,pie,set2,1,1,False,0.16992500144231237,11,1,non-aligned,non-aligned
23,study7Pie,7.0,17,33,1857,30,pie,set4,3,3,False,1.6438561897747246,5,0,start0,aligned
23,study7Pie,9.0,18,34,1858,32,pie,set1,2,2,False,1.0874628412503393,7,2,non-aligned,non-aligned
23,study7Pie,6.0,19,14,1859,12,pie,set4,2,2,False,1.0874628412503393,12,0,start0,aligned
23,study7Pie,8.0,20,21,1860,20,pie,set4,1,1,False,0.16992500144231237,5,0,start0,aligned
23,study7Pie,9.0,21,26,1861,24,pie,set3,2,2,False,1.0874628412503393,1,0,start0,aligned
23,study7Pie,6.0,22,17,1862,15,pie,set2,2,2,False,1.0874628412503393,10,0,start0,aligned
23,study7Pie,6.0,23,14,1863,11,pie,set2,3,3,False,1.6438561897747246,11,0,start0,aligned
23,study7Pie,8.0,24,27,1864,24,pie,set4,3,3,False,1.6438561897747246,1,9,non-aligned,non-aligned
23,study7Pie,10.0,25,33,1865,26,pie,set4,7,7,False,2.8328900141647417,1,1,non-aligned,non-aligned
23,study7Pie,9.0,26,20,1866,14,pie,set1,6,6,False,2.6147098441152083,11,5,non-aligned,non-aligned
23,study7Pie,6.0,27,31,1867,28,pie,set4,3,3,False,1.6438561897747246,3,5,non-aligned,non-aligned
23,study7Pie,7.0,28,36,1868,33,pie,set1,3,3,False,1.6438561897747246,8,6,non-aligned,non-aligned
23,study7Pie,6.0,29,39,1869,37,pie,set3,2,2,False,1.0874628412503393,12,0,start25,aligned
23,study7Pie,7.0,30,19,1870,14,pie,set3,5,5,False,2.357552004618084,11,0,start0,aligned
23,study7Pie,8.0,31,46,1871,42,pie,set1,4,4,False,2.0443941193584534,8,0,start0,aligned
23,study7Pie,6.0,32,38,1872,31,pie,set4,7,7,False,2.8328900141647417,6,0,end50,aligned
23,study7Pie,4.0,33,35,1873,34,pie,set1,1,1,False,0.16992500144231237,9,6,non-aligned,non-aligned
23,study7Pie,6.0,34,24,1874,18,pie,set1,6,6,False,2.6147098441152083,7,1,non-aligned,non-aligned
23,study7Pie,8.0,35,49,1875,49,pie,set2,0,0,True,-3.0,1,8,non-aligned,non-aligned
23,study7Pie,7.0,36,45,1876,42,pie,set3,3,3,False,1.6438561897747246,8,7,non-aligned,non-aligned
23,study7Pie,9.0,37,42,1877,40,pie,set1,2,2,False,1.0874628412503393,10,0,start0,aligned
23,study7Pie,12.0,38,47,1878,45,pie,set4,2,2,False,1.0874628412503393,5,0,start0,aligned
23,study7Pie,8.0,39,48,1879,48,pie,set2,0,0,True,-3.0,2,0,start0,aligned
23,study7Pie,6.0,40,16,1880,12,pie,set3,4,4,False,2.0443941193584534,12,1,non-aligned,non-aligned
23,study7Pie,6.0,41,37,1881,38,pie,set4,-1,1,False,0.16992500144231237,12,6,non-aligned,non-aligned
23,study7Pie,5.0,42,24,1882,15,pie,set4,9,9,False,3.189824558880017,10,4,non-aligned,non-aligned
23,study7Pie,7.0,43,24,1883,17,pie,set1,7,7,False,2.8328900141647417,8,0,start0,aligned
23,study7Pie,7.0,44,37,1884,47,pie,set2,-10,10,False,3.3398500028846247,3,2,non-aligned,non-aligned
23,study7Pie,9.0,45,34,1885,32,pie,set2,2,2,False,1.0874628412503393,7,0,start0,aligned
23,study7Pie,5.0,46,37,1886,34,pie,set1,3,3,False,1.6438561897747246,9,0,start0,aligned
23,study7Pie,8.0,47,30,1887,22,pie,set2,8,8,False,3.0223678130284544,3,0,start0,aligned
23,study7Pie,6.0,48,48,1888,47,pie,set1,1,1,False,0.16992500144231237,3,0,start0,aligned
23,study7Pie,9.0,49,30,1889,20,pie,set2,10,10,False,3.3398500028846247,5,0,start75,aligned
23,study7Pie,6.0,50,39,1890,37,pie,set1,2,2,False,1.0874628412503393,12,0,start0,aligned
23,study7Pie,6.0,51,35,1891,29,pie,set4,6,6,False,2.6147098441152083,4,0,start0,aligned
23,study7Pie,7.0,52,28,1892,22,pie,set1,6,6,False,2.6147098441152083,3,2,non-aligned,non-aligned
23,study7Pie,6.0,53,33,1893,31,pie,set1,2,2,False,1.0874628412503393,6,0,start0,aligned
23,study7Pie,8.0,54,42,1894,41,pie,set2,1,1,False,0.16992500144231237,9,4,non-aligned,non-aligned
23,study7Pie,6.0,55,28,1895,19,pie,set4,9,9,False,3.189824558880017,6,0,start0,aligned
23,study7Pie,6.0,56,49,1896,48,pie,set1,1,1,False,0.16992500144231237,2,9,non-aligned,non-aligned
23,study7Pie,7.0,57,31,1897,26,pie,set3,5,5,False,2.357552004618084,1,0,start0,aligned
23,study7Pie,7.0,58,45,1898,39,pie,set4,6,6,False,2.6147098441152083,11,0,start0,aligned
23,study7Pie,16.0,59,48,1899,44,pie,set3,4,4,False,2.0443941193584534,6,8,non-aligned,non-aligned
23,study7Pie,8.0,60,43,1900,35,pie,set3,8,8,False,3.0223678130284544,10,0,start0,aligned
23,study7Pie,7.0,61,49,1901,49,pie,set4,0,0,True,-3.0,1,0,start0,aligned
23,study7Pie,9.0,62,46,1902,46,pie,set3,0,0,True,-3.0,4,0,start0,aligned
23,study7Pie,9.0,63,30,1903,21,pie,set4,9,9,False,3.189824558880017,4,0,start0,aligned
23,study7Pie,7.0,64,29,1904,23,pie,set1,6,6,False,2.6147098441152083,2,3,non-aligned,non-aligned
23,study7Pie,6.0,65,46,1905,43,pie,set4,3,3,False,1.6438561897747246,7,6,non-aligned,non-aligned
23,study7Pie,8.0,66,27,1906,16,pie,set1,11,11,False,3.4757334309663976,9,0,start0,aligned
23,study7Pie,6.0,67,47,1907,46,pie,set1,1,1,False,0.16992500144231237,4,6,non-aligned,non-aligned
23,study7Pie,5.0,68,43,1908,36,pie,set3,7,7,False,2.8328900141647417,11,3,non-aligned,non-aligned
23,study7Pie,5.0,69,29,1909,18,pie,set3,11,11,False,3.4757334309663976,7,0,start0,aligned
23,study7Pie,8.0,70,42,1910,40,pie,set4,2,2,False,1.0874628412503393,10,2,non-aligned,non-aligned
23,study7Pie,7.0,71,44,1911,43,pie,set3,1,1,False,0.16992500144231237,7,0,start0,aligned
23,study7Pie,6.0,72,37,1912,28,pie,set1,9,9,False,3.189824558880017,3,0,start0,aligned
23,study7Pie,19.0,73,35,1913,25,pie,set1,10,10,False,3.3398500028846247,0,0,start0,aligned
23,study7Pie,6.0,74,23,1914,17,pie,set1,6,6,False,2.6147098441152083,8,0,start25,aligned
23,study7Pie,5.0,75,37,1915,29,pie,set4,8,8,False,3.0223678130284544,4,3,non-aligned,non-aligned
23,study7Pie,6.0,76,35,1916,30,pie,set2,5,5,False,2.357552004618084,5,4,non-aligned,non-aligned
23,study7Pie,6.0,77,50,1917,50,pie,set1,0,0,True,-3.0,0,0,start0,aligned
23,study7Pie,6.0,78,28,1918,16,pie,set3,12,12,False,3.599912842187128,9,3,non-aligned,non-aligned
23,study7Pie,6.0,79,20,1919,13,pie,set2,7,7,False,2.8328900141647417,12,0,start0,aligned
14,study7Pie,12.0,0,23,1120,19,pie,set3,4,4,False,2.0443941193584534,6,0,start0,aligned
14,study7Pie,10.0,1,28,1121,31,pie,set3,-3,3,False,1.6438561897747246,6,0,start0,aligned
14,study7Pie,5.0,2,26,1122,28,pie,set4,-2,2,False,1.0874628412503393,3,0,start0,aligned
14,study7Pie,5.0,3,30,1123,34,pie,set4,-4,4,False,2.0443941193584534,9,0,start0,aligned
14,study7Pie,5.0,4,20,1124,19,pie,set1,1,1,False,0.16992500144231237,6,8,non-aligned,non-aligned
14,study7Pie,17.0,5,18,1125,14,pie,set3,4,4,False,2.0443941193584534,11,0,start0,aligned
14,study7Pie,5.0,6,19,1126,16,pie,set1,3,3,False,1.6438561897747246,9,0,start0,aligned
14,study7Pie,8.0,7,30,1127,32,pie,set3,-2,2,False,1.0874628412503393,7,2,non-aligned,non-aligned
14,study7Pie,6.0,8,40,1128,43,pie,set1,-3,3,False,1.6438561897747246,7,2,non-aligned,non-aligned
14,study7Pie,3.0,9,50,1129,50,pie,set4,0,0,True,-3.0,0,7,non-aligned,non-aligned
14,study7Pie,3.0,10,25,1130,25,pie,set2,0,0,True,-3.0,0,0,start0,aligned
14,study7Pie,7.0,11,27,1131,28,pie,set4,-1,1,False,0.16992500144231237,3,5,non-aligned,non-aligned
14,study7Pie,13.0,12,13,1132,13,pie,set3,0,0,True,-3.0,12,0,start0,aligned
14,study7Pie,4.0,13,15,1133,17,pie,set3,-2,2,False,1.0874628412503393,8,0,start0,aligned
14,study7Pie,24.0,14,10,1134,11,pie,set3,-1,1,False,0.16992500144231237,11,5,non-aligned,non-aligned
14,study7Pie,4.0,15,40,1135,43,pie,set2,-3,3,False,1.6438561897747246,7,0,start0,aligned
14,study7Pie,5.0,16,25,1136,27,pie,set2,-2,2,False,1.0874628412503393,2,11,non-aligned,non-aligned
14,study7Pie,3.0,17,23,1137,23,pie,set3,0,0,True,-3.0,2,0,start0,aligned
14,study7Pie,18.0,18,30,1138,29,pie,set3,1,1,False,0.16992500144231237,4,9,non-aligned,non-aligned
14,study7Pie,10.0,19,30,1139,37,pie,set2,-7,7,False,2.8328900141647417,12,0,start0,aligned
14,study7Pie,13.0,20,15,1140,15,pie,set2,0,0,True,-3.0,10,0,start0,aligned
14,study7Pie,6.0,21,15,1141,15,pie,set1,0,0,True,-3.0,10,5,non-aligned,non-aligned
14,study7Pie,5.0,22,20,1142,23,pie,set2,-3,3,False,1.6438561897747246,2,5,non-aligned,non-aligned
14,study7Pie,6.0,23,38,1143,42,pie,set4,-4,4,False,2.0443941193584534,8,0,start0,aligned
14,study7Pie,3.0,24,40,1144,41,pie,set4,-1,1,False,0.16992500144231237,9,4,non-aligned,non-aligned
14,study7Pie,2.0,25,20,1145,17,pie,set3,3,3,False,1.6438561897747246,8,3,non-aligned,non-aligned
14,study7Pie,4.0,26,25,1146,25,pie,set4,0,0,True,-3.0,0,0,start25,aligned
14,study7Pie,3.0,27,20,1147,21,pie,set3,-1,1,False,0.16992500144231237,4,0,start0,aligned
14,study7Pie,7.0,28,27,1148,30,pie,set1,-3,3,False,1.6438561897747246,5,0,start0,aligned
14,study7Pie,12.0,29,14,1149,14,pie,set4,0,0,True,-3.0,11,6,non-aligned,non-aligned
14,study7Pie,6.0,30,30,1150,36,pie,set4,-6,6,False,2.6147098441152083,11,0,start0,aligned
14,study7Pie,37.0,31,18,1151,18,pie,set2,0,0,True,-3.0,7,0,start0,aligned
14,study7Pie,3.0,32,40,1152,38,pie,set4,2,2,False,1.0874628412503393,12,6,non-aligned,non-aligned
14,study7Pie,10.0,33,30,1153,30,pie,set1,0,0,True,-3.0,5,8,non-aligned,non-aligned
14,study7Pie,37.0,34,36,1154,38,pie,set1,-2,2,False,1.0874628412503393,12,0,start0,aligned
14,study7Pie,5.0,35,45,1155,47,pie,set2,-2,2,False,1.0874628412503393,3,2,non-aligned,non-aligned
14,study7Pie,3.0,36,50,1156,50,pie,set1,0,0,True,-3.0,0,0,start0,aligned
14,study7Pie,8.0,37,13,1157,11,pie,set1,2,2,False,1.0874628412503393,11,0,start0,aligned
14,study7Pie,4.0,38,40,1158,39,pie,set2,1,1,False,0.16992500144231237,11,1,non-aligned,non-aligned
14,study7Pie,10.0,39,25,1159,26,pie,set1,-1,1,False,0.16992500144231237,1,3,non-aligned,non-aligned
14,study7Pie,11.0,40,27,1160,26,pie,set4,1,1,False,0.16992500144231237,1,0,start0,aligned
14,study7Pie,6.0,41,23,1161,24,pie,set2,-1,1,False,0.16992500144231237,1,0,start0,aligned
14,study7Pie,4.0,42,45,1162,48,pie,set2,-3,3,False,1.6438561897747246,2,0,start0,aligned
14,study7Pie,4.0,43,20,1163,20,pie,set1,0,0,True,-3.0,5,0,start0,aligned
14,study7Pie,24.0,44,33,1164,39,pie,set3,-6,6,False,2.6147098441152083,11,0,start0,aligned
14,study7Pie,4.0,45,45,1165,45,pie,set2,0,0,True,-3.0,5,9,non-aligned,non-aligned
14,study7Pie,19.0,46,18,1166,16,pie,set1,2,2,False,1.0874628412503393,9,1,non-aligned,non-aligned
14,study7Pie,40.0,47,20,1167,22,pie,set2,-2,2,False,1.0874628412503393,3,9,non-aligned,non-aligned
14,study7Pie,7.0,48,35,1168,33,pie,set4,2,2,False,1.0874628412503393,8,4,non-aligned,non-aligned
14,study7Pie,10.0,49,24,1169,24,pie,set2,0,0,True,-3.0,1,2,non-aligned,non-aligned
14,study7Pie,18.0,50,13,1170,12,pie,set1,1,1,False,0.16992500144231237,12,0,start0,aligned
14,study7Pie,6.0,51,48,1171,49,pie,set4,-1,1,False,0.16992500144231237,1,0,start0,aligned
14,study7Pie,4.0,52,30,1172,32,pie,set2,-2,2,False,1.0874628412503393,7,0,start0,aligned
14,study7Pie,3.0,53,20,1173,18,pie,set1,2,2,False,1.0874628412503393,7,1,non-aligned,non-aligned
14,study7Pie,4.0,54,20,1174,22,pie,set4,-2,2,False,1.0874628412503393,3,0,start0,aligned
14,study7Pie,9.0,55,35,1175,37,pie,set3,-2,2,False,1.0874628412503393,12,0,start25,aligned
14,study7Pie,10.0,56,15,1176,13,pie,set4,2,2,False,1.0874628412503393,12,6,non-aligned,non-aligned
14,study7Pie,4.0,57,48,1177,49,pie,set4,-1,1,False,0.16992500144231237,1,5,non-aligned,non-aligned
14,study7Pie,5.0,58,33,1178,35,pie,set2,-2,2,False,1.0874628412503393,10,3,non-aligned,non-aligned
14,study7Pie,4.0,59,33,1179,35,pie,set1,-2,2,False,1.0874628412503393,10,0,start0,aligned
14,study7Pie,4.0,60,20,1180,20,pie,set3,0,0,True,-3.0,5,2,non-aligned,non-aligned
14,study7Pie,8.0,61,40,1181,44,pie,set1,-4,4,False,2.0443941193584534,6,2,non-aligned,non-aligned
14,study7Pie,11.0,62,27,1182,27,pie,set1,0,0,True,-3.0,2,0,start0,aligned
14,study7Pie,5.0,63,45,1183,47,pie,set3,-2,2,False,1.0874628412503393,3,0,start0,aligned
14,study7Pie,7.0,64,20,1184,21,pie,set2,-1,1,False,0.16992500144231237,4,6,non-aligned,non-aligned
14,study7Pie,6.0,65,13,1185,12,pie,set1,1,1,False,0.16992500144231237,12,1,non-aligned,non-aligned
14,study7Pie,10.0,66,33,1186,36,pie,set4,-3,3,False,1.6438561897747246,11,3,non-aligned,non-aligned
14,study7Pie,4.0,67,45,1187,44,pie,set2,1,1,False,0.16992500144231237,6,0,start0,aligned
14,study7Pie,20.0,68,35,1188,40,pie,set1,-5,5,False,2.357552004618084,10,0,start0,aligned
14,study7Pie,10.0,69,33,1189,34,pie,set2,-1,1,False,0.16992500144231237,9,2,non-aligned,non-aligned
14,study7Pie,6.0,70,33,1190,33,pie,set2,0,0,True,-3.0,8,0,start0,aligned
14,study7Pie,3.0,71,45,1191,46,pie,set2,-1,1,False,0.16992500144231237,4,9,non-aligned,non-aligned
14,study7Pie,6.0,72,49,1192,48,pie,set1,1,1,False,0.16992500144231237,2,9,non-aligned,non-aligned
14,study7Pie,3.0,73,45,1193,45,pie,set2,0,0,True,-3.0,5,0,start0,aligned
14,study7Pie,5.0,74,27,1194,29,pie,set1,-2,2,False,1.0874628412503393,4,0,start0,aligned
14,study7Pie,10.0,75,37,1195,41,pie,set2,-4,4,False,2.0443941193584534,9,0,start0,aligned
14,study7Pie,12.0,76,30,1196,40,pie,set4,-10,10,False,3.3398500028846247,10,2,non-aligned,non-aligned
14,study7Pie,4.0,77,40,1197,46,pie,set4,-6,6,False,2.6147098441152083,4,0,start0,aligned
14,study7Pie,5.0,78,40,1198,42,pie,set3,-2,2,False,1.0874628412503393,8,7,non-aligned,non-aligned
14,study7Pie,5.0,79,33,1199,31,pie,set3,2,2,False,1.0874628412503393,6,2,non-aligned,non-aligned
0,study7Pie,9.0,0,30,0,23,pie,set3,7,7,False,2.8328900141647417,2,0,start0,aligned
0,study7Pie,8.0,1,34,1,38,pie,set1,-4,4,False,2.0443941193584534,12,0,start0,aligned
0,study7Pie,7.0,2,5,2,11,pie,set1,-6,6,False,2.6147098441152083,11,0,start0,aligned
0,study7Pie,5.0,3,25,3,24,pie,set1,1,1,False,0.16992500144231237,1,0,start0,aligned
0,study7Pie,5.0,4,35,4,28,pie,set3,7,7,False,2.8328900141647417,3,0,start0,aligned
0,study7Pie,9.0,5,15,5,14,pie,set3,1,1,False,0.16992500144231237,11,2,non-aligned,non-aligned
0,study7Pie,4.0,6,15,6,12,pie,set1,3,3,False,1.6438561897747246,12,0,start0,aligned
0,study7Pie,5.0,7,40,7,43,pie,set2,-3,3,False,1.6438561897747246,7,0,start0,aligned
0,study7Pie,7.0,8,20,8,24,pie,set1,-4,4,False,2.0443941193584534,1,5,non-aligned,non-aligned
0,study7Pie,6.0,9,20,9,17,pie,set2,3,3,False,1.6438561897747246,8,0,start0,aligned
0,study7Pie,4.0,10,25,10,35,pie,set3,-10,10,False,3.3398500028846247,10,0,start0,aligned
0,study7Pie,4.0,11,15,11,16,pie,set3,-1,1,False,0.16992500144231237,9,0,start0,aligned
0,study7Pie,4.0,12,20,12,18,pie,set4,2,2,False,1.0874628412503393,7,0,start0,aligned
0,study7Pie,4.0,13,23,13,20,pie,set1,3,3,False,1.6438561897747246,5,0,start0,aligned
0,study7Pie,4.0,14,25,14,36,pie,set2,-11,11,False,3.4757334309663976,11,0,start0,aligned
0,study7Pie,6.0,15,40,15,43,pie,set1,-3,3,False,1.6438561897747246,7,2,non-aligned,non-aligned
0,study7Pie,6.0,16,35,16,35,pie,set2,0,0,True,-3.0,10,3,non-aligned,non-aligned
0,study7Pie,5.0,17,15,17,15,pie,set4,0,0,True,-3.0,10,0,start0,aligned
0,study7Pie,5.0,18,15,18,14,pie,set1,1,1,False,0.16992500144231237,11,0,start0,aligned
0,study7Pie,15.0,19,35,19,37,pie,set2,-2,2,False,1.0874628412503393,12,0,start0,aligned
0,study7Pie,7.0,20,35,20,39,pie,set4,-4,4,False,2.0443941193584534,11,1,non-aligned,non-aligned
0,study7Pie,8.0,21,38,21,44,pie,set3,-6,6,False,2.6147098441152083,6,0,start0,aligned
0,study7Pie,10.0,22,40,22,46,pie,set1,-6,6,False,2.6147098441152083,4,6,non-aligned,non-aligned
0,study7Pie,8.0,23,35,23,31,pie,set4,4,4,False,2.0443941193584534,6,0,start0,aligned
0,study7Pie,6.0,24,30,24,28,pie,set3,2,2,False,1.0874628412503393,3,9,non-aligned,non-aligned
0,study7Pie,4.0,25,25,25,20,pie,set2,5,5,False,2.357552004618084,5,0,start75,aligned
0,study7Pie,7.0,26,40,26,47,pie,set3,-7,7,False,2.8328900141647417,3,10,non-aligned,non-aligned
0,study7Pie,6.0,27,25,27,29,pie,set1,-4,4,False,2.0443941193584534,4,0,start0,aligned
0,study7Pie,25.0,28,30,28,30,pie,set3,0,0,True,-3.0,5,7,non-aligned,non-aligned
0,study7Pie,18.0,29,40,29,48,pie,set4,-8,8,False,3.0223678130284544,2,2,non-aligned,non-aligned
0,study7Pie,4.0,30,35,30,33,pie,set1,2,2,False,1.0874628412503393,8,0,start0,aligned
0,study7Pie,6.0,31,30,31,32,pie,set2,-2,2,False,1.0874628412503393,7,6,non-aligned,non-aligned
0,study7Pie,8.0,32,30,32,30,pie,set3,0,0,True,-3.0,5,0,start0,aligned
0,study7Pie,8.0,33,35,33,40,pie,set4,-5,5,False,2.357552004618084,10,2,non-aligned,non-aligned
0,study7Pie,10.0,34,25,34,21,pie,set3,4,4,False,2.0443941193584534,4,0,start0,aligned
0,study7Pie,5.0,35,30,35,27,pie,set2,3,3,False,1.6438561897747246,2,11,non-aligned,non-aligned
0,study7Pie,11.0,36,40,36,44,pie,set1,-4,4,False,2.0443941193584534,6,2,non-aligned,non-aligned
0,study7Pie,9.0,37,40,37,46,pie,set2,-6,6,False,2.6147098441152083,4,0,start0,aligned
0,study7Pie,6.0,38,36,38,42,pie,set1,-6,6,False,2.6147098441152083,8,3,non-aligned,non-aligned
0,study7Pie,7.0,39,35,39,32,pie,set2,3,3,False,1.6438561897747246,7,0,start0,aligned
0,study7Pie,7.0,40,35,40,33,pie,set2,2,2,False,1.0874628412503393,8,8,non-aligned,non-aligned
0,study7Pie,4.0,41,23,41,21,pie,set1,2,2,False,1.0874628412503393,4,1,non-aligned,non-aligned
0,study7Pie,5.0,42,30,42,25,pie,set1,5,5,False,2.357552004618084,0,7,non-aligned,non-aligned
0,study7Pie,10.0,43,20,43,12,pie,set4,8,8,False,3.0223678130284544,12,6,non-aligned,non-aligned
0,study7Pie,6.0,44,30,44,34,pie,set2,-4,4,False,2.0443941193584534,9,2,non-aligned,non-aligned
0,study7Pie,11.0,45,40,45,42,pie,set4,-2,2,False,1.0874628412503393,8,0,start0,aligned
0,study7Pie,9.0,46,49,46,49,pie,set4,0,0,True,-3.0,1,5,non-aligned,non-aligned
0,study7Pie,6.0,47,30,47,19,pie,set4,11,11,False,3.4757334309663976,6,0,start0,aligned
0,study7Pie,6.0,48,35,48,38,pie,set4,-3,3,False,1.6438561897747246,12,6,non-aligned,non-aligned
0,study7Pie,9.0,49,25,49,26,pie,set4,-1,1,False,0.16992500144231237,1,1,non-aligned,non-aligned
0,study7Pie,5.0,50,30,50,22,pie,set2,8,8,False,3.0223678130284544,3,9,non-aligned,non-aligned
0,study7Pie,6.0,51,25,51,13,pie,set3,12,12,False,3.599912842187128,12,0,start0,aligned
0,study7Pie,14.0,52,30,52,23,pie,set1,7,7,False,2.8328900141647417,2,3,non-aligned,non-aligned
0,study7Pie,5.0,53,30,53,19,pie,set4,11,11,False,3.4757334309663976,6,0,end75,aligned
0,study7Pie,7.0,54,40,54,37,pie,set4,3,3,False,1.6438561897747246,12,1,non-aligned,non-aligned
0,study7Pie,6.0,55,50,55,50,pie,set1,0,0,True,-3.0,0,6,non-aligned,non-aligned
0,study7Pie,5.0,56,35,56,34,pie,set2,1,1,False,0.16992500144231237,9,0,start0,aligned
0,study7Pie,5.0,57,48,57,48,pie,set3,0,0,True,-3.0,2,0,start0,aligned
0,study7Pie,5.0,58,49,58,49,pie,set3,0,0,True,-3.0,1,0,start0,aligned
0,study7Pie,9.0,59,25,59,18,pie,set2,7,7,False,2.8328900141647417,7,1,non-aligned,non-aligned
0,study7Pie,6.0,60,35,60,31,pie,set3,4,4,False,2.0443941193584534,6,2,non-aligned,non-aligned
0,study7Pie,5.0,61,50,61,50,pie,set2,0,0,True,-3.0,0,0,start0,aligned
0,study7Pie,5.0,62,25,62,22,pie,set4,3,3,False,1.6438561897747246,3,0,start0,aligned
0,study7Pie,9.0,63,30,63,36,pie,set1,-6,6,False,2.6147098441152083,11,3,non-aligned,non-aligned
0,study7Pie,6.0,64,25,64,25,pie,set3,0,0,True,-3.0,0,0,start0,aligned
0,study7Pie,25.0,65,25,65,13,pie,set3,12,12,False,3.599912842187128,12,2,non-aligned,non-aligned
0,study7Pie,8.0,66,25,66,15,pie,set4,10,10,False,3.3398500028846247,10,4,non-aligned,non-aligned
0,study7Pie,4.0,67,30,67,29,pie,set3,1,1,False,0.16992500144231237,4,9,non-aligned,non-aligned
0,study7Pie,8.0,68,35,68,39,pie,set3,-4,4,False,2.0443941193584534,11,0,start0,aligned
0,study7Pie,7.0,69,40,69,47,pie,set2,-7,7,False,2.8328900141647417,3,0,start0,aligned
0,study7Pie,8.0,70,25,70,26,pie,set3,-1,1,False,0.16992500144231237,1,0,start0,aligned
0,study7Pie,12.0,71,46,71,41,pie,set4,5,5,False,2.357552004618084,9,4,non-aligned,non-aligned
0,study7Pie,9.0,72,35,72,40,pie,set1,-5,5,False,2.357552004618084,10,0,start0,aligned
0,study7Pie,5.0,73,25,73,27,pie,set4,-2,2,False,1.0874628412503393,2,0,start0,aligned
0,study7Pie,6.0,74,42,74,45,pie,set4,-3,3,False,1.6438561897747246,5,0,start0,aligned
0,study7Pie,6.0,75,13,75,16,pie,set3,-3,3,False,1.6438561897747246,9,3,non-aligned,non-aligned
0,study7Pie,19.0,76,30,76,45,pie,set3,-15,15,False,3.9188632372745946,5,7,non-aligned,non-aligned
0,study7Pie,9.0,77,40,77,41,pie,set3,-1,1,False,0.16992500144231237,9,0,start0,aligned
0,study7Pie,7.0,78,12,78,11,pie,set4,1,1,False,0.16992500144231237,11,4,non-aligned,non-aligned
0,study7Pie,44.0,79,15,79,17,pie,set4,-2,2,False,1.0874628412503393,8,1,non-aligned,non-aligned
33,study7Pie,23.0,0,17,2640,14,pie,set3,3,3,False,1.6438561897747246,11,2,non-aligned,non-aligned
33,study7Pie,9.0,1,25,2641,13,pie,set2,12,12,False,3.599912842187128,12,0,start0,aligned
33,study7Pie,7.0,2,38,2642,30,pie,set2,8,8,False,3.0223678130284544,5,0,start0,aligned
33,study7Pie,6.0,3,46,2643,41,pie,set4,5,5,False,2.357552004618084,9,0,start0,aligned
33,study7Pie,7.0,4,30,2644,19,pie,set4,11,11,False,3.4757334309663976,6,0,end75,aligned
33,study7Pie,10.0,5,37,2645,31,pie,set3,6,6,False,2.6147098441152083,6,2,non-aligned,non-aligned
33,study7Pie,31.0,6,33,2646,29,pie,set4,4,4,False,2.0443941193584534,4,3,non-aligned,non-aligned
33,study7Pie,9.0,7,40,2647,33,pie,set4,7,7,False,2.8328900141647417,8,0,start0,aligned
33,study7Pie,8.0,8,45,2648,37,pie,set3,8,8,False,3.0223678130284544,12,0,start0,aligned
33,study7Pie,8.0,9,48,2649,47,pie,set1,1,1,False,0.16992500144231237,3,0,start0,aligned
33,study7Pie,6.0,10,49,2650,49,pie,set2,0,0,True,-3.0,1,0,start0,aligned
33,study7Pie,7.0,11,30,2651,27,pie,set1,3,3,False,1.6438561897747246,2,2,non-aligned,non-aligned
33,study7Pie,9.0,12,18,2652,17,pie,set4,1,1,False,0.16992500144231237,8,1,non-aligned,non-aligned
33,study7Pie,9.0,13,27,2653,21,pie,set1,6,6,False,2.6147098441152083,4,0,start0,aligned
33,study7Pie,6.0,14,33,2654,32,pie,set3,1,1,False,0.16992500144231237,7,2,non-aligned,non-aligned
33,study7Pie,12.0,15,47,2655,45,pie,set3,2,2,False,1.0874628412503393,5,7,non-aligned,non-aligned
33,study7Pie,9.0,16,29,2656,22,pie,set2,7,7,False,2.8328900141647417,3,9,non-aligned,non-aligned
33,study7Pie,11.0,17,47,2657,47,pie,set4,0,0,True,-3.0,3,10,non-aligned,non-aligned
33,study7Pie,8.0,18,46,2658,36,pie,set4,10,10,False,3.3398500028846247,11,3,non-aligned,non-aligned
33,study7Pie,9.0,19,47,2659,43,pie,set3,4,4,False,2.0443941193584534,7,3,non-aligned,non-aligned
33,study7Pie,6.0,20,25,2660,21,pie,set4,4,4,False,2.0443941193584534,4,2,non-aligned,non-aligned
33,study7Pie,10.0,21,35,2661,32,pie,set1,3,3,False,1.6438561897747246,7,0,start0,aligned
33,study7Pie,8.0,22,23,2662,18,pie,set2,5,5,False,2.357552004618084,7,0,start0,aligned
33,study7Pie,7.0,23,30,2663,16,pie,set4,14,14,False,3.820178962415188,9,3,non-aligned,non-aligned
33,study7Pie,6.0,24,47,2664,44,pie,set4,3,3,False,1.6438561897747246,6,2,non-aligned,non-aligned
33,study7Pie,5.0,25,30,2665,20,pie,set3,10,10,False,3.3398500028846247,5,0,start0,aligned
33,study7Pie,6.0,26,50,2666,50,pie,set3,0,0,True,-3.0,0,0,start0,aligned
33,study7Pie,7.0,27,45,2667,35,pie,set4,10,10,False,3.3398500028846247,10,0,start0,aligned
33,study7Pie,5.0,28,32,2668,25,pie,set1,7,7,False,2.8328900141647417,0,7,non-aligned,non-aligned
33,study7Pie,5.0,29,39,2669,34,pie,set2,5,5,False,2.357552004618084,9,0,start0,aligned
33,study7Pie,7.0,30,31,2670,28,pie,set4,3,3,False,1.6438561897747246,3,5,non-aligned,non-aligned
33,study7Pie,5.0,31,41,2671,33,pie,set4,8,8,False,3.0223678130284544,8,4,non-aligned,non-aligned
33,study7Pie,7.0,32,18,2672,14,pie,set1,4,4,False,2.0443941193584534,11,0,start0,aligned
33,study7Pie,9.0,33,30,2673,23,pie,set2,7,7,False,2.8328900141647417,2,5,non-aligned,non-aligned
33,study7Pie,9.0,34,32,2674,24,pie,set3,8,8,False,3.0223678130284544,1,8,non-aligned,non-aligned
33,study7Pie,6.0,35,47,2675,44,pie,set4,3,3,False,1.6438561897747246,6,0,start0,aligned
33,study7Pie,8.0,36,15,2676,13,pie,set2,2,2,False,1.0874628412503393,12,6,non-aligned,non-aligned
33,study7Pie,8.0,37,48,2677,41,pie,set4,7,7,False,2.8328900141647417,9,4,non-aligned,non-aligned
33,study7Pie,5.0,38,46,2678,40,pie,set1,6,6,False,2.6147098441152083,10,0,start0,aligned
33,study7Pie,9.0,39,27,2679,20,pie,set4,7,7,False,2.8328900141647417,5,5,non-aligned,non-aligned
33,study7Pie,5.0,40,49,2680,49,pie,set1,0,0,True,-3.0,1,8,non-aligned,non-aligned
33,study7Pie,6.0,41,48,2681,46,pie,set4,2,2,False,1.0874628412503393,4,2,non-aligned,non-aligned
33,study7Pie,9.0,42,35,2682,28,pie,set1,7,7,False,2.8328900141647417,3,0,start0,aligned
33,study7Pie,6.0,43,22,2683,16,pie,set1,6,6,False,2.6147098441152083,9,0,start0,aligned
33,study7Pie,7.0,44,30,2684,26,pie,set3,4,4,False,2.0443941193584534,1,3,non-aligned,non-aligned
33,study7Pie,8.0,45,18,2685,12,pie,set3,6,6,False,2.6147098441152083,12,0,start0,aligned
33,study7Pie,6.0,46,50,2686,50,pie,set3,0,0,True,-3.0,0,5,non-aligned,non-aligned
33,study7Pie,7.0,47,46,2687,40,pie,set4,6,6,False,2.6147098441152083,10,2,non-aligned,non-aligned
33,study7Pie,16.0,48,48,2688,48,pie,set1,0,0,True,-3.0,2,0,start0,aligned
33,study7Pie,7.0,49,35,2689,25,pie,set4,10,10,False,3.3398500028846247,0,0,start0,aligned
33,study7Pie,7.0,50,45,2690,37,pie,set2,8,8,False,3.0223678130284544,12,5,non-aligned,non-aligned
33,study7Pie,6.0,51,48,2691,48,pie,set3,0,0,True,-3.0,2,2,non-aligned,non-aligned
33,study7Pie,7.0,52,45,2692,39,pie,set3,6,6,False,2.6147098441152083,11,3,non-aligned,non-aligned
33,study7Pie,10.0,53,24,2693,18,pie,set1,6,6,False,2.6147098441152083,7,1,non-aligned,non-aligned
33,study7Pie,7.0,54,30,2694,26,pie,set2,4,4,False,2.0443941193584534,1,0,start0,aligned
33,study7Pie,8.0,55,40,2695,38,pie,set4,2,2,False,1.0874628412503393,12,0,start0,aligned
33,study7Pie,6.0,56,39,2696,34,pie,set2,5,5,False,2.357552004618084,9,2,non-aligned,non-aligned
33,study7Pie,6.0,57,47,2697,45,pie,set1,2,2,False,1.0874628412503393,5,0,start0,aligned
33,study7Pie,5.0,58,47,2698,43,pie,set3,4,4,False,2.0443941193584534,7,0,start0,aligned
33,study7Pie,6.0,59,30,2699,24,pie,set3,6,6,False,2.6147098441152083,1,0,start0,aligned
33,study7Pie,7.0,60,19,2700,15,pie,set4,4,4,False,2.0443941193584534,10,0,start0,aligned
33,study7Pie,7.0,61,46,2701,46,pie,set2,0,0,True,-3.0,4,0,start0,aligned
33,study7Pie,7.0,62,32,2702,27,pie,set1,5,5,False,2.357552004618084,2,0,start0,aligned
33,study7Pie,5.0,63,28,2703,22,pie,set3,6,6,False,2.6147098441152083,3,0,start0,aligned
33,study7Pie,7.0,64,16,2704,11,pie,set1,5,5,False,2.357552004618084,11,0,start0,aligned
33,study7Pie,8.0,65,45,2705,42,pie,set1,3,3,False,1.6438561897747246,8,3,non-aligned,non-aligned
33,study7Pie,7.0,66,43,2706,36,pie,set4,7,7,False,2.8328900141647417,11,0,start0,aligned
33,study7Pie,10.0,67,44,2707,42,pie,set3,2,2,False,1.0874628412503393,8,0,start0,aligned
33,study7Pie,10.0,68,18,2708,12,pie,set3,6,6,False,2.6147098441152083,12,1,non-aligned,non-aligned
33,study7Pie,5.0,69,33,2709,30,pie,set4,3,3,False,1.6438561897747246,5,1,non-aligned,non-aligned
33,study7Pie,8.0,70,23,2710,15,pie,set4,8,8,False,3.0223678130284544,10,4,non-aligned,non-aligned
33,study7Pie,7.0,71,24,2711,19,pie,set4,5,5,False,2.357552004618084,6,0,start0,aligned
33,study7Pie,9.0,72,24,2712,23,pie,set4,1,1,False,0.16992500144231237,2,0,start0,aligned
33,study7Pie,6.0,73,21,2713,17,pie,set3,4,4,False,2.0443941193584534,8,0,start0,aligned
33,study7Pie,13.0,74,40,2714,31,pie,set2,9,9,False,3.189824558880017,6,0,start0,aligned
33,study7Pie,6.0,75,45,2715,38,pie,set3,7,7,False,2.8328900141647417,12,3,non-aligned,non-aligned
33,study7Pie,7.0,76,38,2716,29,pie,set1,9,9,False,3.189824558880017,4,0,start0,aligned
33,study7Pie,6.0,77,45,2717,39,pie,set1,6,6,False,2.6147098441152083,11,0,start0,aligned
33,study7Pie,7.0,78,19,2718,11,pie,set1,8,8,False,3.0223678130284544,11,4,non-aligned,non-aligned
33,study7Pie,6.0,79,46,2719,35,pie,set2,11,11,False,3.4757334309663976,10,3,non-aligned,non-aligned
9,study7Pie,8.0,0,45,720,44,pie,set3,1,1,False,0.16992500144231237,6,8,non-aligned,non-aligned
9,study7Pie,7.0,1,26,721,17,pie,set2,9,9,False,3.189824558880017,8,0,start0,aligned
9,study7Pie,7.0,2,48,722,45,pie,set1,3,3,False,1.6438561897747246,5,2,non-aligned,non-aligned
9,study7Pie,5.0,3,24,723,24,pie,set2,0,0,True,-3.0,1,0,start0,aligned
9,study7Pie,4.0,4,22,724,21,pie,set1,1,1,False,0.16992500144231237,4,0,start0,aligned
9,study7Pie,4.0,5,15,725,15,pie,set4,0,0,True,-3.0,10,4,non-aligned,non-aligned
9,study7Pie,5.0,6,46,726,47,pie,set3,-1,1,False,0.16992500144231237,3,10,non-aligned,non-aligned
9,study7Pie,9.0,7,19,727,20,pie,set1,-1,1,False,0.16992500144231237,5,0,start75,aligned
9,study7Pie,7.0,8,15,728,13,pie,set2,2,2,False,1.0874628412503393,12,6,non-aligned,non-aligned
9,study7Pie,4.0,9,13,729,12,pie,set3,1,1,False,0.16992500144231237,12,0,start0,aligned
9,study7Pie,7.0,10,30,730,30,pie,set4,0,0,True,-3.0,5,0,start0,aligned
9,study7Pie,5.0,11,45,731,44,pie,set2,1,1,False,0.16992500144231237,6,0,start0,aligned
9,study7Pie,5.0,12,49,732,49,pie,set1,0,0,True,-3.0,1,8,non-aligned,non-aligned
9,study7Pie,13.0,13,35,733,38,pie,set1,-3,3,False,1.6438561897747246,12,1,non-aligned,non-aligned
9,study7Pie,8.0,14,30,734,35,pie,set1,-5,5,False,2.357552004618084,10,6,non-aligned,non-aligned
9,study7Pie,4.0,15,27,735,27,pie,set3,0,0,True,-3.0,2,0,start0,aligned
9,study7Pie,4.0,16,27,736,29,pie,set2,-2,2,False,1.0874628412503393,4,2,non-aligned,non-aligned
9,study7Pie,4.0,17,44,737,43,pie,set2,1,1,False,0.16992500144231237,7,2,non-aligned,non-aligned
9,study7Pie,6.0,18,45,738,46,pie,set2,-1,1,False,0.16992500144231237,4,9,non-aligned,non-aligned
9,study7Pie,5.0,19,20,739,19,pie,set3,1,1,False,0.16992500144231237,6,0,start0,aligned
9,study7Pie,12.0,20,35,740,36,pie,set4,-1,1,False,0.16992500144231237,11,3,non-aligned,non-aligned
9,study7Pie,7.0,21,30,741,28,pie,set1,2,2,False,1.0874628412503393,3,10,non-aligned,non-aligned
9,study7Pie,6.0,22,40,742,42,pie,set2,-2,2,False,1.0874628412503393,8,4,non-aligned,non-aligned
9,study7Pie,6.0,23,22,743,24,pie,set1,-2,2,False,1.0874628412503393,1,5,non-aligned,non-aligned
9,study7Pie,6.0,24,40,744,40,pie,set2,0,0,True,-3.0,10,0,start0,aligned
9,study7Pie,3.0,25,40,745,36,pie,set1,4,4,False,2.0443941193584534,11,0,start0,aligned
9,study7Pie,4.0,26,22,746,22,pie,set1,0,0,True,-3.0,3,2,non-aligned,non-aligned
9,study7Pie,7.0,27,40,747,39,pie,set1,1,1,False,0.16992500144231237,11,4,non-aligned,non-aligned
9,study7Pie,6.0,28,30,748,30,pie,set4,0,0,True,-3.0,5,1,non-aligned,non-aligned
9,study7Pie,3.0,29,25,749,25,pie,set2,0,0,True,-3.0,0,0,start0,aligned
9,study7Pie,5.0,30,35,750,35,pie,set2,0,0,True,-3.0,10,0,start0,aligned
9,study7Pie,5.0,31,45,751,45,pie,set3,0,0,True,-3.0,5,0,start0,aligned
9,study7Pie,3.0,32,50,752,50,pie,set2,0,0,True,-3.0,0,0,start0,aligned
9,study7Pie,3.0,33,48,753,48,pie,set2,0,0,True,-3.0,2,0,start0,aligned
9,study7Pie,6.0,34,42,754,42,pie,set4,0,0,True,-3.0,8,0,start0,aligned
9,study7Pie,3.0,35,25,755,27,pie,set2,-2,2,False,1.0874628412503393,2,11,non-aligned,non-aligned
9,study7Pie,12.0,36,10,756,14,pie,set1,-4,4,False,2.0443941193584534,11,5,non-aligned,non-aligned
9,study7Pie,3.0,37,30,757,29,pie,set1,1,1,False,0.16992500144231237,4,0,start0,aligned
9,study7Pie,4.0,38,24,758,25,pie,set2,-1,1,False,0.16992500144231237,0,8,non-aligned,non-aligned
9,study7Pie,4.0,39,20,759,18,pie,set1,2,2,False,1.0874628412503393,7,0,start0,aligned
9,study7Pie,5.0,40,40,760,43,pie,set2,-3,3,False,1.6438561897747246,7,0,start0,aligned
9,study7Pie,8.0,41,35,761,37,pie,set3,-2,2,False,1.0874628412503393,12,0,start25,aligned
9,study7Pie,5.0,42,20,762,16,pie,set4,4,4,False,2.0443941193584534,9,0,start0,aligned
9,study7Pie,8.0,43,40,763,34,pie,set3,6,6,False,2.6147098441152083,9,3,non-aligned,non-aligned
9,study7Pie,4.0,44,35,764,34,pie,set1,1,1,False,0.16992500144231237,9,0,start0,aligned
9,study7Pie,3.0,45,20,765,15,pie,set1,5,5,False,2.357552004618084,10,0,start0,aligned
9,study7Pie,3.0,46,48,766,49,pie,set2,-1,1,False,0.16992500144231237,1,0,start0,aligned
9,study7Pie,4.0,47,23,767,23,pie,set2,0,0,True,-3.0,2,0,start0,aligned
9,study7Pie,3.0,48,20,768,19,pie,set4,1,1,False,0.16992500144231237,6,0,end75,aligned
9,study7Pie,4.0,49,24,769,26,pie,set2,-2,2,False,1.0874628412503393,1,10,non-aligned,non-aligned
9,study7Pie,6.0,50,33,770,33,pie,set3,0,0,True,-3.0,8,3,non-aligned,non-aligned
9,study7Pie,4.0,51,14,771,11,pie,set4,3,3,False,1.6438561897747246,11,0,start0,aligned
9,study7Pie,3.0,52,15,772,16,pie,set2,-1,1,False,0.16992500144231237,9,2,non-aligned,non-aligned
9,study7Pie,5.0,53,30,773,31,pie,set3,-1,1,False,0.16992500144231237,6,2,non-aligned,non-aligned
9,study7Pie,5.0,54,40,774,39,pie,set3,1,1,False,0.16992500144231237,11,0,start0,aligned
9,study7Pie,5.0,55,47,775,47,pie,set2,0,0,True,-3.0,3,0,start0,aligned
9,study7Pie,4.0,56,28,776,28,pie,set2,0,0,True,-3.0,3,0,start0,aligned
9,study7Pie,4.0,57,50,777,50,pie,set3,0,0,True,-3.0,0,5,non-aligned,non-aligned
9,study7Pie,5.0,58,15,778,13,pie,set4,2,2,False,1.0874628412503393,12,0,start0,aligned
9,study7Pie,5.0,59,46,779,48,pie,set2,-2,2,False,1.0874628412503393,2,2,non-aligned,non-aligned
9,study7Pie,3.0,60,15,780,11,pie,set4,4,4,False,2.0443941193584534,11,4,non-aligned,non-aligned
9,study7Pie,7.0,61,42,781,40,pie,set4,2,2,False,1.0874628412503393,10,2,non-aligned,non-aligned
9,study7Pie,5.0,62,15,782,14,pie,set4,1,1,False,0.16992500144231237,11,0,start0,aligned
9,study7Pie,5.0,63,22,783,22,pie,set4,0,0,True,-3.0,3,0,start0,aligned
9,study7Pie,7.0,64,12,784,12,pie,set3,0,0,True,-3.0,12,1,non-aligned,non-aligned
9,study7Pie,3.0,65,23,785,23,pie,set3,0,0,True,-3.0,2,10,non-aligned,non-aligned
9,study7Pie,6.0,66,32,786,33,pie,set2,-1,1,False,0.16992500144231237,8,0,start0,aligned
9,study7Pie,4.0,67,30,787,31,pie,set2,-1,1,False,0.16992500144231237,6,0,start0,aligned
9,study7Pie,3.0,68,22,788,20,pie,set3,2,2,False,1.0874628412503393,5,0,start0,aligned
9,study7Pie,3.0,69,35,789,32,pie,set4,3,3,False,1.6438561897747246,7,7,non-aligned,non-aligned
9,study7Pie,5.0,70,40,790,41,pie,set3,-1,1,False,0.16992500144231237,9,0,start0,aligned
9,study7Pie,3.0,71,26,791,26,pie,set3,0,0,True,-3.0,1,0,start0,aligned
9,study7Pie,6.0,72,38,792,37,pie,set1,1,1,False,0.16992500144231237,12,0,start0,aligned
9,study7Pie,8.0,73,17,793,17,pie,set3,0,0,True,-3.0,8,3,non-aligned,non-aligned
9,study7Pie,4.0,74,16,794,21,pie,set2,-5,5,False,2.357552004618084,4,6,non-aligned,non-aligned
9,study7Pie,8.0,75,19,795,18,pie,set1,1,1,False,0.16992500144231237,7,1,non-aligned,non-aligned
9,study7Pie,4.0,76,45,796,46,pie,set1,-1,1,False,0.16992500144231237,4,0,start0,aligned
9,study7Pie,10.0,77,38,797,41,pie,set4,-3,3,False,1.6438561897747246,9,4,non-aligned,non-aligned
9,study7Pie,6.0,78,33,798,32,pie,set1,1,1,False,0.16992500144231237,7,0,start0,aligned
9,study7Pie,7.0,79,37,799,38,pie,set3,-1,1,False,0.16992500144231237,12,0,start0,aligned
30,study7Pie,12.0,0,40,2400,40,pie,set4,0,0,True,-3.0,10,0,start0,aligned
30,study7Pie,8.0,1,35,2401,41,pie,set2,-6,6,False,2.6147098441152083,9,4,non-aligned,non-aligned
30,study7Pie,10.0,2,33,2402,33,pie,set2,0,0,True,-3.0,8,0,start0,aligned
30,study7Pie,12.0,3,22,2403,27,pie,set1,-5,5,False,2.357552004618084,2,0,start0,aligned
30,study7Pie,8.0,4,27,2404,26,pie,set1,1,1,False,0.16992500144231237,1,0,start0,aligned
30,study7Pie,11.0,5,30,2405,31,pie,set1,-1,1,False,0.16992500144231237,6,0,start0,aligned
30,study7Pie,8.0,6,33,2406,32,pie,set1,1,1,False,0.16992500144231237,7,2,non-aligned,non-aligned
30,study7Pie,10.0,7,35,2407,36,pie,set2,-1,1,False,0.16992500144231237,11,0,start0,aligned
30,study7Pie,8.0,8,30,2408,30,pie,set2,0,0,True,-3.0,5,0,start0,aligned
30,study7Pie,8.0,9,37,2409,35,pie,set4,2,2,False,1.0874628412503393,10,0,end100,aligned
30,study7Pie,15.0,10,22,2410,25,pie,set3,-3,3,False,1.6438561897747246,0,5,non-aligned,non-aligned
30,study7Pie,10.0,11,18,2411,18,pie,set3,0,0,True,-3.0,7,2,non-aligned,non-aligned
30,study7Pie,9.0,12,47,2412,46,pie,set3,1,1,False,0.16992500144231237,4,10,non-aligned,non-aligned
30,study7Pie,5.0,13,18,2413,19,pie,set2,-1,1,False,0.16992500144231237,6,0,start0,aligned
30,study7Pie,6.0,14,37,2414,40,pie,set4,-3,3,False,1.6438561897747246,10,2,non-aligned,non-aligned
30,study7Pie,4.0,15,15,2415,12,pie,set1,3,3,False,1.6438561897747246,12,0,start0,aligned
30,study7Pie,4.0,16,28,2416,28,pie,set2,0,0,True,-3.0,3,8,non-aligned,non-aligned
30,study7Pie,5.0,17,39,2417,39,pie,set3,0,0,True,-3.0,11,0,start0,aligned
30,study7Pie,5.0,18,15,2418,13,pie,set3,2,2,False,1.0874628412503393,12,2,non-aligned,non-aligned
30,study7Pie,3.0,19,15,2419,14,pie,set1,1,1,False,0.16992500144231237,11,5,non-aligned,non-aligned
30,study7Pie,4.0,20,20,2420,15,pie,set3,5,5,False,2.357552004618084,10,3,non-aligned,non-aligned
30,study7Pie,5.0,21,35,2421,34,pie,set2,1,1,False,0.16992500144231237,9,0,start0,aligned
30,study7Pie,6.0,22,37,2422,37,pie,set2,0,0,True,-3.0,12,0,start0,aligned
30,study7Pie,7.0,23,17,2423,21,pie,set2,-4,4,False,2.0443941193584534,4,0,start0,aligned
30,study7Pie,8.0,24,28,2424,27,pie,set1,1,1,False,0.16992500144231237,2,2,non-aligned,non-aligned
30,study7Pie,15.0,25,38,2425,38,pie,set3,0,0,True,-3.0,12,0,start0,aligned
30,study7Pie,8.0,26,15,2426,15,pie,set3,0,0,True,-3.0,10,0,start0,aligned
30,study7Pie,5.0,27,48,2427,49,pie,set2,-1,1,False,0.16992500144231237,1,0,start0,aligned
30,study7Pie,4.0,28,18,2428,16,pie,set2,2,2,False,1.0874628412503393,9,0,start0,aligned
30,study7Pie,4.0,29,25,2429,26,pie,set2,-1,1,False,0.16992500144231237,1,10,non-aligned,non-aligned
30,study7Pie,4.0,30,50,2430,50,pie,set4,0,0,True,-3.0,0,0,start0,aligned
30,study7Pie,6.0,31,30,2431,31,pie,set1,-1,1,False,0.16992500144231237,6,4,non-aligned,non-aligned
30,study7Pie,6.0,32,23,2432,22,pie,set1,1,1,False,0.16992500144231237,3,0,start0,aligned
30,study7Pie,5.0,33,40,2433,44,pie,set2,-4,4,False,2.0443941193584534,6,9,non-aligned,non-aligned
30,study7Pie,5.0,34,30,2434,32,pie,set1,-2,2,False,1.0874628412503393,7,0,start0,aligned
30,study7Pie,5.0,35,28,2435,29,pie,set3,-1,1,False,0.16992500144231237,4,0,start0,aligned
30,study7Pie,4.0,36,12,2436,11,pie,set2,1,1,False,0.16992500144231237,11,2,non-aligned,non-aligned
30,study7Pie,4.0,37,22,2437,24,pie,set2,-2,2,False,1.0874628412503393,1,0,start0,aligned
30,study7Pie,7.0,38,20,2438,18,pie,set4,2,2,False,1.0874628412503393,7,0,start0,aligned
30,study7Pie,5.0,39,23,2439,23,pie,set2,0,0,True,-3.0,2,0,start0,aligned
30,study7Pie,5.0,40,38,2440,38,pie,set1,0,0,True,-3.0,12,1,non-aligned,non-aligned
30,study7Pie,3.0,41,50,2441,50,pie,set4,0,0,True,-3.0,0,7,non-aligned,non-aligned
30,study7Pie,4.0,42,45,2442,44,pie,set2,1,1,False,0.16992500144231237,6,0,start0,aligned
30,study7Pie,7.0,43,22,2443,24,pie,set2,-2,2,False,1.0874628412503393,1,2,non-aligned,non-aligned
30,study7Pie,6.0,44,20,2444,19,pie,set3,1,1,False,0.16992500144231237,6,1,non-aligned,non-aligned
30,study7Pie,4.0,45,22,2445,23,pie,set4,-1,1,False,0.16992500144231237,2,10,non-aligned,non-aligned
30,study7Pie,3.0,46,15,2446,12,pie,set3,3,3,False,1.6438561897747246,12,1,non-aligned,non-aligned
30,study7Pie,4.0,47,33,2447,34,pie,set1,-1,1,False,0.16992500144231237,9,6,non-aligned,non-aligned
30,study7Pie,22.0,48,15,2448,17,pie,set1,-2,2,False,1.0874628412503393,8,0,start25,aligned
30,study7Pie,4.0,49,15,2449,17,pie,set3,-2,2,False,1.0874628412503393,8,0,start0,aligned
30,study7Pie,3.0,50,45,2450,42,pie,set2,3,3,False,1.6438561897747246,8,4,non-aligned,non-aligned
30,study7Pie,4.0,51,23,2451,25,pie,set4,-2,2,False,1.0874628412503393,0,0,start0,aligned
30,study7Pie,3.0,52,20,2452,20,pie,set3,0,0,True,-3.0,5,2,non-aligned,non-aligned
30,study7Pie,4.0,53,18,2453,13,pie,set3,5,5,False,2.357552004618084,12,0,start0,aligned
30,study7Pie,4.0,54,46,2454,45,pie,set2,1,1,False,0.16992500144231237,5,9,non-aligned,non-aligned
30,study7Pie,6.0,55,21,2455,21,pie,set2,0,0,True,-3.0,4,6,non-aligned,non-aligned
30,study7Pie,4.0,56,40,2456,46,pie,set3,-6,6,False,2.6147098441152083,4,0,start0,aligned
30,study7Pie,4.0,57,39,2457,43,pie,set4,-4,4,False,2.0443941193584534,7,0,start0,aligned
30,study7Pie,4.0,58,42,2458,45,pie,set1,-3,3,False,1.6438561897747246,5,0,start0,aligned
30,study7Pie,3.0,59,15,2459,14,pie,set4,1,1,False,0.16992500144231237,11,0,start0,aligned
30,study7Pie,5.0,60,40,2460,43,pie,set1,-3,3,False,1.6438561897747246,7,2,non-aligned,non-aligned
30,study7Pie,5.0,61,42,2461,39,pie,set4,3,3,False,1.6438561897747246,11,1,non-aligned,non-aligned
30,study7Pie,5.0,62,35,2462,33,pie,set1,2,2,False,1.0874628412503393,8,6,non-aligned,non-aligned
30,study7Pie,5.0,63,30,2463,35,pie,set2,-5,5,False,2.357552004618084,10,0,start0,aligned
30,study7Pie,6.0,64,22,2464,22,pie,set2,0,0,True,-3.0,3,9,non-aligned,non-aligned
30,study7Pie,4.0,65,47,2465,47,pie,set3,0,0,True,-3.0,3,0,start0,aligned
30,study7Pie,5.0,66,28,2466,29,pie,set3,-1,1,False,0.16992500144231237,4,9,non-aligned,non-aligned
30,study7Pie,3.0,67,48,2467,48,pie,set4,0,0,True,-3.0,2,0,start0,aligned
30,study7Pie,4.0,68,20,2468,20,pie,set4,0,0,True,-3.0,5,0,start0,aligned
30,study7Pie,6.0,69,29,2469,30,pie,set3,-1,1,False,0.16992500144231237,5,7,non-aligned,non-aligned
30,study7Pie,5.0,70,38,2470,37,pie,set3,1,1,False,0.16992500144231237,12,0,start25,aligned
30,study7Pie,4.0,71,33,2471,36,pie,set2,-3,3,False,1.6438561897747246,11,1,non-aligned,non-aligned
30,study7Pie,7.0,72,28,2472,28,pie,set1,0,0,True,-3.0,3,0,start0,aligned
30,study7Pie,3.0,73,12,2473,11,pie,set1,1,1,False,0.16992500144231237,11,0,start0,aligned
30,study7Pie,5.0,74,38,2474,41,pie,set1,-3,3,False,1.6438561897747246,9,0,start0,aligned
30,study7Pie,3.0,75,47,2475,48,pie,set2,-1,1,False,0.16992500144231237,2,2,non-aligned,non-aligned
30,study7Pie,5.0,76,48,2476,47,pie,set3,1,1,False,0.16992500144231237,3,10,non-aligned,non-aligned
30,study7Pie,6.0,77,19,2477,16,pie,set2,3,3,False,1.6438561897747246,9,2,non-aligned,non-aligned
30,study7Pie,13.0,78,42,2478,42,pie,set1,0,0,True,-3.0,8,0,start0,aligned
30,study7Pie,5.0,79,49,2479,49,pie,set2,0,0,True,-3.0,1,8,non-aligned,non-aligned
3,study7Pie,37.0,0,40,240,41,pie,set2,-1,1,False,0.16992500144231237,9,4,non-aligned,non-aligned
3,study7Pie,7.0,1,40,241,42,pie,set1,-2,2,False,1.0874628412503393,8,0,start0,aligned
3,study7Pie,8.0,2,40,242,39,pie,set1,1,1,False,0.16992500144231237,11,4,non-aligned,non-aligned
3,study7Pie,7.0,3,35,243,33,pie,set3,2,2,False,1.0874628412503393,8,0,start0,aligned
3,study7Pie,9.0,4,23,244,22,pie,set1,1,1,False,0.16992500144231237,3,0,start0,aligned
3,study7Pie,10.0,5,35,245,38,pie,set1,-3,3,False,1.6438561897747246,12,0,start0,aligned
3,study7Pie,11.0,6,38,246,41,pie,set2,-3,3,False,1.6438561897747246,9,0,start0,aligned
3,study7Pie,9.0,7,20,247,20,pie,set3,0,0,True,-3.0,5,0,start0,aligned
3,study7Pie,12.0,8,20,248,17,pie,set1,3,3,False,1.6438561897747246,8,0,start0,aligned
3,study7Pie,28.0,9,30,249,30,pie,set4,0,0,True,-3.0,5,1,non-aligned,non-aligned
3,study7Pie,7.0,10,22,250,21,pie,set2,1,1,False,0.16992500144231237,4,0,start0,aligned
3,study7Pie,10.0,11,28,251,28,pie,set2,0,0,True,-3.0,3,8,non-aligned,non-aligned
3,study7Pie,10.0,12,16,252,15,pie,set1,1,1,False,0.16992500144231237,10,5,non-aligned,non-aligned
3,study7Pie,14.0,13,50,253,50,pie,set4,0,0,True,-3.0,0,7,non-aligned,non-aligned
3,study7Pie,8.0,14,48,254,48,pie,set4,0,0,True,-3.0,2,2,non-aligned,non-aligned
3,study7Pie,6.0,15,20,255,19,pie,set2,1,1,False,0.16992500144231237,6,0,start0,aligned
3,study7Pie,16.0,16,33,256,35,pie,set1,-2,2,False,1.0874628412503393,10,0,start0,aligned
3,study7Pie,10.0,17,35,257,37,pie,set3,-2,2,False,1.0874628412503393,12,0,start0,aligned
3,study7Pie,6.0,18,35,258,40,pie,set4,-5,5,False,2.357552004618084,10,2,non-aligned,non-aligned
3,study7Pie,7.0,19,20,259,18,pie,set4,2,2,False,1.0874628412503393,7,0,start0,aligned
3,study7Pie,8.0,20,42,260,42,pie,set2,0,0,True,-3.0,8,4,non-aligned,non-aligned
3,study7Pie,8.0,21,28,261,27,pie,set2,1,1,False,0.16992500144231237,2,0,start0,aligned
3,study7Pie,10.0,22,24,262,24,pie,set1,0,0,True,-3.0,1,0,start0,aligned
3,study7Pie,7.0,23,28,263,28,pie,set1,0,0,True,-3.0,3,0,start0,aligned
3,study7Pie,9.0,24,48,264,49,pie,set3,-1,1,False,0.16992500144231237,1,0,start0,aligned
3,study7Pie,10.0,25,20,265,20,pie,set4,0,0,True,-3.0,5,5,non-aligned,non-aligned
3,study7Pie,8.0,26,21,266,24,pie,set1,-3,3,False,1.6438561897747246,1,5,non-aligned,non-aligned
3,study7Pie,6.0,27,45,267,45,pie,set2,0,0,True,-3.0,5,9,non-aligned,non-aligned
3,study7Pie,10.0,28,35,268,34,pie,set4,1,1,False,0.16992500144231237,9,2,non-aligned,non-aligned
3,study7Pie,19.0,29,12,269,13,pie,set2,-1,1,False,0.16992500144231237,12,0,start0,aligned
3,study7Pie,11.0,30,10,270,11,pie,set3,-1,1,False,0.16992500144231237,11,0,start0,aligned
3,study7Pie,20.0,31,15,271,16,pie,set2,-1,1,False,0.16992500144231237,9,0,start0,aligned
3,study7Pie,21.0,32,10,272,12,pie,set3,-2,2,False,1.0874628412503393,12,1,non-aligned,non-aligned
3,study7Pie,8.0,33,48,273,48,pie,set1,0,0,True,-3.0,2,0,start0,aligned
3,study7Pie,26.0,34,20,274,14,pie,set2,6,6,False,2.6147098441152083,11,0,start0,aligned
3,study7Pie,8.0,35,12,275,12,pie,set2,0,0,True,-3.0,12,0,start0,aligned
3,study7Pie,13.0,36,12,276,11,pie,set1,1,1,False,0.16992500144231237,11,4,non-aligned,non-aligned
3,study7Pie,6.0,37,40,277,45,pie,set1,-5,5,False,2.357552004618084,5,0,start0,aligned
3,study7Pie,9.0,38,40,278,43,pie,set2,-3,3,False,1.6438561897747246,7,0,start0,aligned
3,study7Pie,29.0,39,39,279,37,pie,set4,2,2,False,1.0874628412503393,12,1,non-aligned,non-aligned
3,study7Pie,8.0,40,30,280,33,pie,set1,-3,3,False,1.6438561897747246,8,6,non-aligned,non-aligned
3,study7Pie,15.0,41,28,281,29,pie,set4,-1,1,False,0.16992500144231237,4,0,start0,aligned
3,study7Pie,10.0,42,40,282,40,pie,set1,0,0,True,-3.0,10,0,start0,aligned
3,study7Pie,7.0,43,29,283,31,pie,set1,-2,2,False,1.0874628412503393,6,4,non-aligned,non-aligned
3,study7Pie,6.0,44,10,284,13,pie,set4,-3,3,False,1.6438561897747246,12,6,non-aligned,non-aligned
3,study7Pie,16.0,45,38,285,35,pie,set2,3,3,False,1.6438561897747246,10,3,non-aligned,non-aligned
3,study7Pie,38.0,46,27,286,29,pie,set1,-2,2,False,1.0874628412503393,4,2,non-aligned,non-aligned
3,study7Pie,8.0,47,45,287,43,pie,set1,2,2,False,1.0874628412503393,7,2,non-aligned,non-aligned
3,study7Pie,12.0,48,40,288,39,pie,set4,1,1,False,0.16992500144231237,11,0,start0,aligned
3,study7Pie,6.0,49,38,289,32,pie,set2,6,6,False,2.6147098441152083,7,0,start0,aligned
3,study7Pie,7.0,50,23,290,21,pie,set3,2,2,False,1.0874628412503393,4,2,non-aligned,non-aligned
3,study7Pie,7.0,51,20,291,14,pie,set3,6,6,False,2.6147098441152083,11,2,non-aligned,non-aligned
3,study7Pie,7.0,52,45,292,46,pie,set2,-1,1,False,0.16992500144231237,4,9,non-aligned,non-aligned
3,study7Pie,8.0,53,26,293,26,pie,set2,0,0,True,-3.0,1,0,start0,aligned
3,study7Pie,10.0,54,50,294,50,pie,set3,0,0,True,-3.0,0,0,start0,aligned
3,study7Pie,6.0,55,47,295,46,pie,set2,1,1,False,0.16992500144231237,4,0,start0,aligned
3,study7Pie,43.0,56,33,296,34,pie,set1,-1,1,False,0.16992500144231237,9,0,start0,aligned
3,study7Pie,6.0,57,25,297,25,pie,set3,0,0,True,-3.0,0,0,start0,aligned
3,study7Pie,14.0,58,26,298,26,pie,set3,0,0,True,-3.0,1,3,non-aligned,non-aligned
3,study7Pie,8.0,59,46,299,47,pie,set3,-1,1,False,0.16992500144231237,3,10,non-aligned,non-aligned
3,study7Pie,12.0,60,29,300,31,pie,set1,-2,2,False,1.0874628412503393,6,0,start0,aligned
3,study7Pie,6.0,61,33,301,36,pie,set3,-3,3,False,1.6438561897747246,11,0,start0,aligned
3,study7Pie,6.0,62,20,302,15,pie,set4,5,5,False,2.357552004618084,10,0,start0,aligned
3,study7Pie,12.0,63,40,303,38,pie,set1,2,2,False,1.0874628412503393,12,1,non-aligned,non-aligned
3,study7Pie,13.0,64,31,304,32,pie,set2,-1,1,False,0.16992500144231237,7,6,non-aligned,non-aligned
3,study7Pie,8.0,65,22,305,22,pie,set1,0,0,True,-3.0,3,2,non-aligned,non-aligned
3,study7Pie,6.0,66,24,306,25,pie,set1,-1,1,False,0.16992500144231237,0,7,non-aligned,non-aligned
3,study7Pie,48.0,67,47,307,44,pie,set2,3,3,False,1.6438561897747246,6,0,start0,aligned
3,study7Pie,11.0,68,28,308,30,pie,set4,-2,2,False,1.0874628412503393,5,0,start0,aligned
3,study7Pie,54.0,69,33,309,36,pie,set1,-3,3,False,1.6438561897747246,11,3,non-aligned,non-aligned
3,study7Pie,8.0,70,47,310,44,pie,set4,3,3,False,1.6438561897747246,6,2,non-aligned,non-aligned
3,study7Pie,6.0,71,23,311,23,pie,set1,0,0,True,-3.0,2,0,start0,aligned
3,study7Pie,11.0,72,24,312,27,pie,set2,-3,3,False,1.6438561897747246,2,11,non-aligned,non-aligned
3,study7Pie,14.0,73,49,313,49,pie,set4,0,0,True,-3.0,1,5,non-aligned,non-aligned
3,study7Pie,6.0,74,23,314,23,pie,set4,0,0,True,-3.0,2,10,non-aligned,non-aligned
3,study7Pie,8.0,75,20,315,17,pie,set3,3,3,False,1.6438561897747246,8,3,non-aligned,non-aligned
3,study7Pie,13.0,76,21,316,16,pie,set2,5,5,False,2.357552004618084,9,2,non-aligned,non-aligned
3,study7Pie,15.0,77,22,317,18,pie,set1,4,4,False,2.0443941193584534,7,1,non-aligned,non-aligned
3,study7Pie,7.0,78,22,318,19,pie,set3,3,3,False,1.6438561897747246,6,1,non-aligned,non-aligned
3,study7Pie,9.0,79,44,319,47,pie,set2,-3,3,False,1.6438561897747246,3,0,start0,aligned
25,study7Pie,13.0,0,40,2000,36,pie,set2,4,4,False,2.0443941193584534,11,0,start0,aligned
25,study7Pie,13.0,1,50,2001,49,pie,set1,1,1,False,0.16992500144231237,1,8,non-aligned,non-aligned
25,study7Pie,8.0,2,25,2002,30,pie,set3,-5,5,False,2.357552004618084,5,7,non-aligned,non-aligned
25,study7Pie,7.0,3,40,2003,44,pie,set4,-4,4,False,2.0443941193584534,6,0,start0,aligned
25,study7Pie,8.0,4,40,2004,47,pie,set3,-7,7,False,2.8328900141647417,3,10,non-aligned,non-aligned
25,study7Pie,10.0,5,15,2005,15,pie,set4,0,0,True,-3.0,10,4,non-aligned,non-aligned
25,study7Pie,8.0,6,10,2006,11,pie,set3,-1,1,False,0.16992500144231237,11,5,non-aligned,non-aligned
25,study7Pie,8.0,7,40,2007,43,pie,set2,-3,3,False,1.6438561897747246,7,2,non-aligned,non-aligned
25,study7Pie,30.0,8,30,2008,21,pie,set2,9,9,False,3.189824558880017,4,6,non-aligned,non-aligned
25,study7Pie,5.0,9,15,2009,11,pie,set1,4,4,False,2.0443941193584534,11,0,start0,aligned
25,study7Pie,7.0,10,15,2010,13,pie,set1,2,2,False,1.0874628412503393,12,6,non-aligned,non-aligned
25,study7Pie,7.0,11,20,2011,19,pie,set4,1,1,False,0.16992500144231237,6,0,start0,aligned
25,study7Pie,7.0,12,40,2012,46,pie,set4,-6,6,False,2.6147098441152083,4,2,non-aligned,non-aligned
25,study7Pie,5.0,13,30,2013,25,pie,set1,5,5,False,2.357552004618084,0,0,start0,aligned
25,study7Pie,166.0,14,20,2014,22,pie,set1,-2,2,False,1.0874628412503393,3,0,start0,aligned
25,study7Pie,9.0,15,30,2015,24,pie,set1,6,6,False,2.6147098441152083,1,5,non-aligned,non-aligned
25,study7Pie,10.0,16,40,2016,42,pie,set3,-2,2,False,1.0874628412503393,8,7,non-aligned,non-aligned
25,study7Pie,6.0,17,30,2017,31,pie,set3,-1,1,False,0.16992500144231237,6,2,non-aligned,non-aligned
25,study7Pie,5.0,18,20,2018,14,pie,set4,6,6,False,2.6147098441152083,11,0,start0,aligned
25,study7Pie,6.0,19,45,2019,44,pie,set1,1,1,False,0.16992500144231237,6,2,non-aligned,non-aligned
25,study7Pie,10.0,20,30,2020,32,pie,set4,-2,2,False,1.0874628412503393,7,7,non-aligned,non-aligned
25,study7Pie,5.0,21,30,2021,37,pie,set1,-7,7,False,2.8328900141647417,12,0,start0,aligned
25,study7Pie,4.0,22,30,2022,32,pie,set4,-2,2,False,1.0874628412503393,7,0,start0,aligned
25,study7Pie,3.0,23,35,2023,39,pie,set4,-4,4,False,2.0443941193584534,11,1,non-aligned,non-aligned
25,study7Pie,4.0,24,30,2024,38,pie,set2,-8,8,False,3.0223678130284544,12,0,start0,aligned
25,study7Pie,3.0,25,30,2025,34,pie,set3,-4,4,False,2.0443941193584534,9,0,start0,aligned
25,study7Pie,5.0,26,50,2026,50,pie,set2,0,0,True,-3.0,0,0,start0,aligned
25,study7Pie,4.0,27,20,2027,20,pie,set3,0,0,True,-3.0,5,2,non-aligned,non-aligned
25,study7Pie,4.0,28,15,2028,22,pie,set3,-7,7,False,2.8328900141647417,3,2,non-aligned,non-aligned
25,study7Pie,4.0,29,20,2029,27,pie,set2,-7,7,False,2.8328900141647417,2,11,non-aligned,non-aligned
25,study7Pie,4.0,30,40,2030,45,pie,set3,-5,5,False,2.357552004618084,5,0,start0,aligned
25,study7Pie,4.0,31,45,2031,46,pie,set3,-1,1,False,0.16992500144231237,4,0,start0,aligned
25,study7Pie,4.0,32,25,2032,20,pie,set3,5,5,False,2.357552004618084,5,0,start0,aligned
25,study7Pie,4.0,33,30,2033,35,pie,set4,-5,5,False,2.357552004618084,10,0,end100,aligned
25,study7Pie,4.0,34,50,2034,47,pie,set3,3,3,False,1.6438561897747246,3,0,start0,aligned
25,study7Pie,4.0,35,15,2035,14,pie,set1,1,1,False,0.16992500144231237,11,5,non-aligned,non-aligned
25,study7Pie,4.0,36,30,2036,28,pie,set2,2,2,False,1.0874628412503393,3,0,start0,aligned
25,study7Pie,4.0,37,35,2037,37,pie,set3,-2,2,False,1.0874628412503393,12,0,start25,aligned
25,study7Pie,4.0,38,25,2038,16,pie,set4,9,9,False,3.189824558880017,9,0,start0,aligned
25,study7Pie,4.0,39,40,2039,41,pie,set4,-1,1,False,0.16992500144231237,9,0,start0,aligned
25,study7Pie,4.0,40,45,2040,40,pie,set1,5,5,False,2.357552004618084,10,0,start0,aligned
25,study7Pie,4.0,41,45,2041,43,pie,set3,2,2,False,1.0874628412503393,7,0,start0,aligned
25,study7Pie,4.0,42,15,2042,16,pie,set3,-1,1,False,0.16992500144231237,9,3,non-aligned,non-aligned
25,study7Pie,6.0,43,35,2043,33,pie,set1,2,2,False,1.0874628412503393,8,6,non-aligned,non-aligned
25,study7Pie,9.0,44,30,2044,29,pie,set2,1,1,False,0.16992500144231237,4,0,start0,aligned
25,study7Pie,5.0,45,20,2045,12,pie,set3,8,8,False,3.0223678130284544,12,1,non-aligned,non-aligned
25,study7Pie,7.0,46,40,2046,42,pie,set1,-2,2,False,1.0874628412503393,8,0,start0,aligned
25,study7Pie,4.0,47,30,2047,28,pie,set1,2,2,False,1.0874628412503393,3,10,non-aligned,non-aligned
25,study7Pie,4.0,48,15,2048,15,pie,set4,0,0,True,-3.0,10,0,start0,aligned
25,study7Pie,4.0,49,30,2049,30,pie,set1,0,0,True,-3.0,5,0,start0,aligned
25,study7Pie,4.0,50,30,2050,31,pie,set1,-1,1,False,0.16992500144231237,6,0,start0,aligned
25,study7Pie,4.0,51,20,2051,19,pie,set2,1,1,False,0.16992500144231237,6,2,non-aligned,non-aligned
25,study7Pie,4.0,52,40,2052,49,pie,set4,-9,9,False,3.189824558880017,1,0,start0,aligned
25,study7Pie,4.0,53,40,2053,45,pie,set1,-5,5,False,2.357552004618084,5,2,non-aligned,non-aligned
25,study7Pie,4.0,54,30,2054,23,pie,set1,7,7,False,2.8328900141647417,2,0,start0,aligned
25,study7Pie,4.0,55,40,2055,40,pie,set2,0,0,True,-3.0,10,1,non-aligned,non-aligned
25,study7Pie,5.0,56,20,2056,21,pie,set4,-1,1,False,0.16992500144231237,4,0,start0,aligned
25,study7Pie,4.0,57,20,2057,24,pie,set1,-4,4,False,2.0443941193584534,1,0,start0,aligned
25,study7Pie,4.0,58,15,2058,17,pie,set4,-2,2,False,1.0874628412503393,8,1,non-aligned,non-aligned
25,study7Pie,5.0,59,35,2059,36,pie,set4,-1,1,False,0.16992500144231237,11,3,non-aligned,non-aligned
25,study7Pie,4.0,60,40,2060,48,pie,set3,-8,8,False,3.0223678130284544,2,0,start0,aligned
25,study7Pie,3.0,61,30,2061,26,pie,set4,4,4,False,2.0443941193584534,1,0,start0,aligned
25,study7Pie,4.0,62,25,2062,26,pie,set2,-1,1,False,0.16992500144231237,1,10,non-aligned,non-aligned
25,study7Pie,12.0,63,30,2063,35,pie,set3,-5,5,False,2.357552004618084,10,0,start0,aligned
25,study7Pie,4.0,64,45,2064,50,pie,set3,-5,5,False,2.357552004618084,0,5,non-aligned,non-aligned
25,study7Pie,3.0,65,15,2065,18,pie,set3,-3,3,False,1.6438561897747246,7,2,non-aligned,non-aligned
25,study7Pie,4.0,66,15,2066,12,pie,set1,3,3,False,1.6438561897747246,12,0,start0,aligned
25,study7Pie,11.0,67,20,2067,27,pie,set4,-7,7,False,2.8328900141647417,2,0,start0,aligned
25,study7Pie,4.0,68,20,2068,17,pie,set2,3,3,False,1.6438561897747246,8,0,start0,aligned
25,study7Pie,4.0,69,30,2069,34,pie,set4,-4,4,False,2.0443941193584534,9,2,non-aligned,non-aligned
25,study7Pie,4.0,70,40,2070,38,pie,set1,2,2,False,1.0874628412503393,12,1,non-aligned,non-aligned
25,study7Pie,7.0,71,35,2071,33,pie,set2,2,2,False,1.0874628412503393,8,0,start0,aligned
25,study7Pie,4.0,72,15,2072,13,pie,set1,2,2,False,1.0874628412503393,12,0,start0,aligned
25,study7Pie,4.0,73,40,2073,48,pie,set3,-8,8,False,3.0223678130284544,2,2,non-aligned,non-aligned
25,study7Pie,3.0,74,30,2074,39,pie,set4,-9,9,False,3.189824558880017,11,0,start0,aligned
25,study7Pie,4.0,75,25,2075,23,pie,set4,2,2,False,1.0874628412503393,2,10,non-aligned,non-aligned
25,study7Pie,4.0,76,35,2076,41,pie,set3,-6,6,False,2.6147098441152083,9,1,non-aligned,non-aligned
25,study7Pie,4.0,77,30,2077,29,pie,set4,1,1,False,0.16992500144231237,4,3,non-aligned,non-aligned
25,study7Pie,3.0,78,25,2078,25,pie,set4,0,0,True,-3.0,0,0,start25,aligned
25,study7Pie,5.0,79,20,2079,18,pie,set4,2,2,False,1.0874628412503393,7,0,start0,aligned
39,study7Pie,59.0,0,7,3120,11,pie,set2,-4,4,False,2.0443941193584534,11,0,start0,aligned
39,study7Pie,22.0,1,45,3121,37,pie,set4,8,8,False,3.0223678130284544,12,1,non-aligned,non-aligned
39,study7Pie,13.0,2,25,3122,30,pie,set4,-5,5,False,2.357552004618084,5,1,non-aligned,non-aligned
39,study7Pie,17.0,3,25,3123,22,pie,set4,3,3,False,1.6438561897747246,3,0,start0,aligned
39,study7Pie,11.0,4,35,3124,32,pie,set1,3,3,False,1.6438561897747246,7,0,start0,aligned
39,study7Pie,21.0,5,30,3125,30,pie,set3,0,0,True,-3.0,5,0,start0,aligned
39,study7Pie,17.0,6,47,3126,47,pie,set3,0,0,True,-3.0,3,10,non-aligned,non-aligned
39,study7Pie,17.0,7,15,3127,17,pie,set1,-2,2,False,1.0874628412503393,8,0,start0,aligned
39,study7Pie,19.0,8,47,3128,44,pie,set4,3,3,False,1.6438561897747246,6,2,non-aligned,non-aligned
39,study7Pie,24.0,9,40,3129,37,pie,set1,3,3,False,1.6438561897747246,12,0,start0,aligned
39,study7Pie,27.0,10,15,3130,17,pie,set4,-2,2,False,1.0874628412503393,8,1,non-aligned,non-aligned
39,study7Pie,10.0,11,15,3131,15,pie,set4,0,0,True,-3.0,10,0,start0,aligned
39,study7Pie,28.0,12,20,3132,27,pie,set2,-7,7,False,2.8328900141647417,2,11,non-aligned,non-aligned
39,study7Pie,17.0,13,40,3133,43,pie,set4,-3,3,False,1.6438561897747246,7,6,non-aligned,non-aligned
39,study7Pie,17.0,14,45,3134,43,pie,set3,2,2,False,1.0874628412503393,7,0,start0,aligned
39,study7Pie,16.0,15,45,3135,41,pie,set4,4,4,False,2.0443941193584534,9,0,start0,aligned
39,study7Pie,27.0,16,40,3136,46,pie,set1,-6,6,False,2.6147098441152083,4,6,non-aligned,non-aligned
39,study7Pie,29.0,17,15,3137,16,pie,set4,-1,1,False,0.16992500144231237,9,3,non-aligned,non-aligned
39,study7Pie,25.0,18,23,3138,26,pie,set3,-3,3,False,1.6438561897747246,1,0,start0,aligned
39,study7Pie,10.0,19,50,3139,50,pie,set3,0,0,True,-3.0,0,5,non-aligned,non-aligned
39,study7Pie,23.0,20,20,3140,14,pie,set2,6,6,False,2.6147098441152083,11,0,start0,aligned
39,study7Pie,17.0,21,25,3141,26,pie,set4,-1,1,False,0.16992500144231237,1,1,non-aligned,non-aligned
39,study7Pie,25.0,22,15,3142,16,pie,set4,-1,1,False,0.16992500144231237,9,0,start0,aligned
39,study7Pie,16.0,23,10,3143,18,pie,set2,-8,8,False,3.0223678130284544,7,1,non-aligned,non-aligned
39,study7Pie,25.0,24,25,3144,27,pie,set2,-2,2,False,1.0874628412503393,2,0,start0,aligned
39,study7Pie,19.0,25,40,3145,34,pie,set2,6,6,False,2.6147098441152083,9,0,start0,aligned
39,study7Pie,20.0,26,40,3146,46,pie,set1,-6,6,False,2.6147098441152083,4,0,start0,aligned
39,study7Pie,15.0,27,45,3147,48,pie,set3,-3,3,False,1.6438561897747246,2,2,non-aligned,non-aligned
39,study7Pie,19.0,28,25,3148,29,pie,set1,-4,4,False,2.0443941193584534,4,2,non-aligned,non-aligned
39,study7Pie,17.0,29,40,3149,38,pie,set1,2,2,False,1.0874628412503393,12,0,start0,aligned
39,study7Pie,39.0,30,10,3150,11,pie,set3,-1,1,False,0.16992500144231237,11,5,non-aligned,non-aligned
39,study7Pie,14.0,31,40,3151,40,pie,set4,0,0,True,-3.0,10,2,non-aligned,non-aligned
39,study7Pie,19.0,32,40,3152,45,pie,set2,-5,5,False,2.357552004618084,5,9,non-aligned,non-aligned
39,study7Pie,12.0,33,45,3153,47,pie,set1,-2,2,False,1.0874628412503393,3,0,start0,aligned
39,study7Pie,14.0,34,47,3154,48,pie,set3,-1,1,False,0.16992500144231237,2,0,start0,aligned
39,study7Pie,24.0,35,15,3155,13,pie,set2,2,2,False,1.0874628412503393,12,0,start0,aligned
39,study7Pie,18.0,36,25,3156,28,pie,set3,-3,3,False,1.6438561897747246,3,0,start0,aligned
39,study7Pie,96.0,37,35,3157,33,pie,set3,2,2,False,1.0874628412503393,8,3,non-aligned,non-aligned
39,study7Pie,21.0,38,35,3158,40,pie,set3,-5,5,False,2.357552004618084,10,0,start0,aligned
39,study7Pie,17.0,39,30,3159,31,pie,set4,-1,1,False,0.16992500144231237,6,0,end50,aligned
39,study7Pie,50.0,40,30,3160,35,pie,set2,-5,5,False,2.357552004618084,10,3,non-aligned,non-aligned
39,study7Pie,18.0,41,30,3161,34,pie,set1,-4,4,False,2.0443941193584534,9,6,non-aligned,non-aligned
39,study7Pie,14.0,42,35,3162,39,pie,set4,-4,4,False,2.0443941193584534,11,1,non-aligned,non-aligned
39,study7Pie,23.0,43,40,3163,35,pie,set1,5,5,False,2.357552004618084,10,0,start0,aligned
39,study7Pie,17.0,44,45,3164,42,pie,set3,3,3,False,1.6438561897747246,8,0,start0,aligned
39,study7Pie,26.0,45,15,3165,18,pie,set3,-3,3,False,1.6438561897747246,7,0,start0,aligned
39,study7Pie,20.0,46,20,3166,22,pie,set4,-2,2,False,1.0874628412503393,3,0,start75,aligned
39,study7Pie,17.0,47,40,3167,41,pie,set1,-1,1,False,0.16992500144231237,9,6,non-aligned,non-aligned
39,study7Pie,23.0,48,20,3168,19,pie,set3,1,1,False,0.16992500144231237,6,1,non-aligned,non-aligned
39,study7Pie,11.0,49,45,3169,44,pie,set1,1,1,False,0.16992500144231237,6,0,start0,aligned
39,study7Pie,18.0,50,20,3170,24,pie,set4,-4,4,False,2.0443941193584534,1,0,start0,aligned
39,study7Pie,29.0,51,20,3171,20,pie,set3,0,0,True,-3.0,5,0,start0,aligned
39,study7Pie,21.0,52,10,3172,12,pie,set1,-2,2,False,1.0874628412503393,12,1,non-aligned,non-aligned
39,study7Pie,17.0,53,30,3173,31,pie,set4,-1,1,False,0.16992500144231237,6,0,start0,aligned
39,study7Pie,31.0,54,15,3174,13,pie,set3,2,2,False,1.0874628412503393,12,2,non-aligned,non-aligned
39,study7Pie,26.0,55,45,3175,49,pie,set4,-4,4,False,2.0443941193584534,1,5,non-aligned,non-aligned
39,study7Pie,12.0,56,40,3176,39,pie,set3,1,1,False,0.16992500144231237,11,0,start0,aligned
39,study7Pie,15.0,57,20,3177,24,pie,set1,-4,4,False,2.0443941193584534,1,5,non-aligned,non-aligned
39,study7Pie,11.0,58,45,3178,49,pie,set3,-4,4,False,2.0443941193584534,1,0,start0,aligned
39,study7Pie,13.0,59,33,3179,32,pie,set2,1,1,False,0.16992500144231237,7,6,non-aligned,non-aligned
39,study7Pie,15.0,60,20,3180,20,pie,set1,0,0,True,-3.0,5,0,start75,aligned
39,study7Pie,14.0,61,15,3181,14,pie,set4,1,1,False,0.16992500144231237,11,6,non-aligned,non-aligned
39,study7Pie,14.0,62,25,3182,28,pie,set1,-3,3,False,1.6438561897747246,3,10,non-aligned,non-aligned
39,study7Pie,14.0,63,20,3183,19,pie,set1,1,1,False,0.16992500144231237,6,0,start0,aligned
39,study7Pie,14.0,64,20,3184,25,pie,set3,-5,5,False,2.357552004618084,0,5,non-aligned,non-aligned
39,study7Pie,15.0,65,35,3185,38,pie,set1,-3,3,False,1.6438561897747246,12,1,non-aligned,non-aligned
39,study7Pie,16.0,66,20,3186,23,pie,set3,-3,3,False,1.6438561897747246,2,10,non-aligned,non-aligned
39,study7Pie,12.0,67,35,3187,42,pie,set2,-7,7,False,2.8328900141647417,8,4,non-aligned,non-aligned
39,study7Pie,22.0,68,25,3188,29,pie,set2,-4,4,False,2.0443941193584534,4,0,start0,aligned
39,study7Pie,18.0,69,33,3189,36,pie,set2,-3,3,False,1.6438561897747246,11,1,non-aligned,non-aligned
39,study7Pie,18.0,70,15,3190,12,pie,set3,3,3,False,1.6438561897747246,12,0,start0,aligned
39,study7Pie,17.0,71,15,3191,21,pie,set3,-6,6,False,2.6147098441152083,4,2,non-aligned,non-aligned
39,study7Pie,17.0,72,20,3192,25,pie,set1,-5,5,False,2.357552004618084,0,0,start0,aligned
39,study7Pie,17.0,73,20,3193,23,pie,set4,-3,3,False,1.6438561897747246,2,0,start0,aligned
39,study7Pie,12.0,74,50,3194,50,pie,set4,0,0,True,-3.0,0,0,start0,aligned
39,study7Pie,9.0,75,45,3195,45,pie,set4,0,0,True,-3.0,5,0,start0,aligned
39,study7Pie,29.0,76,20,3196,15,pie,set1,5,5,False,2.357552004618084,10,5,non-aligned,non-aligned
39,study7Pie,13.0,77,20,3197,21,pie,set1,-1,1,False,0.16992500144231237,4,0,start0,aligned
39,study7Pie,16.0,78,35,3198,33,pie,set2,2,2,False,1.0874628412503393,8,0,start0,aligned
39,study7Pie,14.0,79,40,3199,36,pie,set2,4,4,False,2.0443941193584534,11,0,start0,aligned
17,study7Pie,12.0,0,40,1360,42,pie,set2,-2,2,False,1.0874628412503393,8,0,start0,aligned
17,study7Pie,16.0,1,15,1361,13,pie,set3,2,2,False,1.0874628412503393,12,0,start0,aligned
17,study7Pie,29.0,2,20,1362,19,pie,set2,1,1,False,0.16992500144231237,6,2,non-aligned,non-aligned
17,study7Pie,13.0,3,20,1363,18,pie,set4,2,2,False,1.0874628412503393,7,0,start0,aligned
17,study7Pie,10.0,4,30,1364,32,pie,set3,-2,2,False,1.0874628412503393,7,2,non-aligned,non-aligned
17,study7Pie,10.0,5,15,1365,14,pie,set1,1,1,False,0.16992500144231237,11,5,non-aligned,non-aligned
17,study7Pie,7.0,6,15,1366,15,pie,set4,0,0,True,-3.0,10,4,non-aligned,non-aligned
17,study7Pie,9.0,7,45,1367,45,pie,set4,0,0,True,-3.0,5,0,start0,aligned
17,study7Pie,19.0,8,40,1368,41,pie,set2,-1,1,False,0.16992500144231237,9,0,start0,aligned
17,study7Pie,16.0,9,35,1369,34,pie,set1,1,1,False,0.16992500144231237,9,6,non-aligned,non-aligned
17,study7Pie,9.0,10,35,1370,36,pie,set1,-1,1,False,0.16992500144231237,11,0,start0,aligned
17,study7Pie,8.0,11,30,1371,31,pie,set2,-1,1,False,0.16992500144231237,6,0,start0,aligned
17,study7Pie,20.0,12,20,1372,17,pie,set2,3,3,False,1.6438561897747246,8,0,start0,aligned
17,study7Pie,10.0,13,25,1373,25,pie,set2,0,0,True,-3.0,0,8,non-aligned,non-aligned
17,study7Pie,12.0,14,45,1374,47,pie,set2,-2,2,False,1.0874628412503393,3,0,start0,aligned
17,study7Pie,15.0,15,30,1375,31,pie,set2,-1,1,False,0.16992500144231237,6,1,non-aligned,non-aligned
17,study7Pie,10.0,16,35,1376,32,pie,set4,3,3,False,1.6438561897747246,7,0,start0,aligned
17,study7Pie,21.0,17,15,1377,16,pie,set3,-1,1,False,0.16992500144231237,9,0,start0,aligned
17,study7Pie,21.0,18,25,1378,27,pie,set3,-2,2,False,1.0874628412503393,2,6,non-aligned,non-aligned
17,study7Pie,16.0,19,15,1379,14,pie,set3,1,1,False,0.16992500144231237,11,0,start0,aligned
17,study7Pie,15.0,20,30,1380,41,pie,set2,-11,11,False,3.4757334309663976,9,4,non-aligned,non-aligned
17,study7Pie,9.0,21,40,1381,47,pie,set1,-7,7,False,2.8328900141647417,3,2,non-aligned,non-aligned
17,study7Pie,10.0,22,35,1382,42,pie,set1,-7,7,False,2.8328900141647417,8,3,non-aligned,non-aligned
17,study7Pie,7.0,23,45,1383,46,pie,set2,-1,1,False,0.16992500144231237,4,9,non-aligned,non-aligned
17,study7Pie,19.0,24,30,1384,33,pie,set2,-3,3,False,1.6438561897747246,8,8,non-aligned,non-aligned
17,study7Pie,11.0,25,45,1385,39,pie,set2,6,6,False,2.6147098441152083,11,0,start0,aligned
17,study7Pie,17.0,26,30,1386,30,pie,set3,0,0,True,-3.0,5,7,non-aligned,non-aligned
17,study7Pie,20.0,27,15,1387,16,pie,set3,-1,1,False,0.16992500144231237,9,3,non-aligned,non-aligned
17,study7Pie,12.0,28,50,1388,50,pie,set3,0,0,True,-3.0,0,5,non-aligned,non-aligned
17,study7Pie,11.0,29,20,1389,18,pie,set3,2,2,False,1.0874628412503393,7,2,non-aligned,non-aligned
17,study7Pie,15.0,30,45,1390,39,pie,set4,6,6,False,2.6147098441152083,11,1,non-aligned,non-aligned
17,study7Pie,6.0,31,15,1391,13,pie,set1,2,2,False,1.0874628412503393,12,6,non-aligned,non-aligned
17,study7Pie,0.0,32,15,1392,12,pie,set2,3,3,False,1.6438561897747246,12,0,start0,aligned
17,study7Pie,9.0,33,50,1393,49,pie,set1,1,1,False,0.16992500144231237,1,8,non-aligned,non-aligned
17,study7Pie,6.0,34,45,1394,45,pie,set1,0,0,True,-3.0,5,2,non-aligned,non-aligned
17,study7Pie,7.0,35,30,1395,28,pie,set1,2,2,False,1.0874628412503393,3,10,non-aligned,non-aligned
17,study7Pie,6.0,36,30,1396,29,pie,set1,1,1,False,0.16992500144231237,4,0,start0,aligned
17,study7Pie,8.0,37,25,1397,25,pie,set3,0,0,True,-3.0,0,0,start0,aligned
17,study7Pie,6.0,38,45,1398,46,pie,set1,-1,1,False,0.16992500144231237,4,0,start0,aligned
17,study7Pie,10.0,39,20,1399,21,pie,set4,-1,1,False,0.16992500144231237,4,0,start0,aligned
17,study7Pie,15.0,40,15,1400,12,pie,set3,3,3,False,1.6438561897747246,12,1,non-aligned,non-aligned
17,study7Pie,6.0,41,25,1401,24,pie,set2,1,1,False,0.16992500144231237,1,2,non-aligned,non-aligned
17,study7Pie,7.0,42,15,1402,15,pie,set4,0,0,True,-3.0,10,0,start0,aligned
17,study7Pie,19.0,43,33,1403,35,pie,set3,-2,2,False,1.0874628412503393,10,0,start0,aligned
17,study7Pie,10.0,44,47,1404,48,pie,set4,-1,1,False,0.16992500144231237,2,2,non-aligned,non-aligned
17,study7Pie,9.0,45,30,1405,33,pie,set2,-3,3,False,1.6438561897747246,8,0,start0,aligned
17,study7Pie,7.0,46,48,1406,49,pie,set3,-1,1,False,0.16992500144231237,1,0,start0,aligned
17,study7Pie,6.0,47,40,1407,44,pie,set2,-4,4,False,2.0443941193584534,6,9,non-aligned,non-aligned
17,study7Pie,10.0,48,23,1408,21,pie,set2,2,2,False,1.0874628412503393,4,6,non-aligned,non-aligned
17,study7Pie,10.0,49,20,1409,17,pie,set3,3,3,False,1.6438561897747246,8,3,non-aligned,non-aligned
17,study7Pie,10.0,50,28,1410,29,pie,set1,-1,1,False,0.16992500144231237,4,2,non-aligned,non-aligned
17,study7Pie,9.0,51,35,1411,37,pie,set1,-2,2,False,1.0874628412503393,12,0,start0,aligned
17,study7Pie,11.0,52,20,1412,20,pie,set4,0,0,True,-3.0,5,5,non-aligned,non-aligned
17,study7Pie,11.0,53,30,1413,35,pie,set2,-5,5,False,2.357552004618084,10,3,non-aligned,non-aligned
17,study7Pie,8.0,54,30,1414,28,pie,set2,2,2,False,1.0874628412503393,3,0,start0,aligned
17,study7Pie,16.0,55,38,1415,40,pie,set4,-2,2,False,1.0874628412503393,10,2,non-aligned,non-aligned
17,study7Pie,7.0,56,27,1416,27,pie,set3,0,0,True,-3.0,2,0,start0,aligned
17,study7Pie,8.0,57,40,1417,43,pie,set1,-3,3,False,1.6438561897747246,7,2,non-aligned,non-aligned
17,study7Pie,7.0,58,30,1418,30,pie,set3,0,0,True,-3.0,5,0,start0,aligned
17,study7Pie,6.0,59,20,1419,20,pie,set2,0,0,True,-3.0,5,0,start0,aligned
17,study7Pie,9.0,60,45,1420,43,pie,set2,2,2,False,1.0874628412503393,7,0,start0,aligned
17,study7Pie,7.0,61,30,1421,36,pie,set4,-6,6,False,2.6147098441152083,11,3,non-aligned,non-aligned
17,study7Pie,9.0,62,34,1422,38,pie,set4,-4,4,False,2.0443941193584534,12,6,non-aligned,non-aligned
17,study7Pie,7.0,63,35,1423,34,pie,set3,1,1,False,0.16992500144231237,9,0,start0,aligned
17,study7Pie,13.0,64,26,1424,26,pie,set1,0,0,True,-3.0,1,3,non-aligned,non-aligned
17,study7Pie,4.0,65,10,1425,11,pie,set1,-1,1,False,0.16992500144231237,11,0,start0,aligned
17,study7Pie,7.0,66,20,1426,19,pie,set2,1,1,False,0.16992500144231237,6,0,start0,aligned
17,study7Pie,6.0,67,23,1427,22,pie,set4,1,1,False,0.16992500144231237,3,0,start0,aligned
17,study7Pie,6.0,68,24,1428,23,pie,set2,1,1,False,0.16992500144231237,2,0,start0,aligned
17,study7Pie,9.0,69,35,1429,40,pie,set3,-5,5,False,2.357552004618084,10,0,start0,aligned
17,study7Pie,5.0,70,50,1430,50,pie,set2,0,0,True,-3.0,0,0,start0,aligned
17,study7Pie,7.0,71,47,1431,48,pie,set1,-1,1,False,0.16992500144231237,2,0,start0,aligned
17,study7Pie,10.0,72,23,1432,23,pie,set1,0,0,True,-3.0,2,3,non-aligned,non-aligned
17,study7Pie,8.0,73,30,1433,37,pie,set1,-7,7,False,2.8328900141647417,12,6,non-aligned,non-aligned
17,study7Pie,7.0,74,26,1434,26,pie,set4,0,0,True,-3.0,1,0,start0,aligned
17,study7Pie,11.0,75,45,1435,44,pie,set2,1,1,False,0.16992500144231237,6,0,start0,aligned
17,study7Pie,5.0,76,10,1436,11,pie,set4,-1,1,False,0.16992500144231237,11,4,non-aligned,non-aligned
17,study7Pie,8.0,77,24,1437,24,pie,set1,0,0,True,-3.0,1,0,start0,aligned
17,study7Pie,9.0,78,24,1438,22,pie,set3,2,2,False,1.0874628412503393,3,2,non-aligned,non-aligned
17,study7Pie,7.0,79,32,1439,38,pie,set4,-6,6,False,2.6147098441152083,12,0,start0,aligned
20,study7Pie,11.0,0,50,1600,50,pie,set4,0,0,True,-3.0,0,0,start0,aligned
20,study7Pie,9.0,1,25,1601,27,pie,set1,-2,2,False,1.0874628412503393,2,0,start0,aligned
20,study7Pie,12.0,2,40,1602,37,pie,set4,3,3,False,1.6438561897747246,12,0,start0,aligned
20,study7Pie,12.0,3,35,1603,33,pie,set3,2,2,False,1.0874628412503393,8,0,start0,aligned
20,study7Pie,7.0,4,45,1604,42,pie,set1,3,3,False,1.6438561897747246,8,0,start0,aligned
20,study7Pie,7.0,5,25,1605,24,pie,set3,1,1,False,0.16992500144231237,1,8,non-aligned,non-aligned
20,study7Pie,11.0,6,15,1606,14,pie,set1,1,1,False,0.16992500144231237,11,5,non-aligned,non-aligned
20,study7Pie,17.0,7,20,1607,16,pie,set1,4,4,False,2.0443941193584534,9,1,non-aligned,non-aligned
20,study7Pie,7.0,8,45,1608,46,pie,set4,-1,1,False,0.16992500144231237,4,2,non-aligned,non-aligned
20,study7Pie,7.0,9,45,1609,41,pie,set1,4,4,False,2.0443941193584534,9,6,non-aligned,non-aligned
20,study7Pie,7.0,10,50,1610,50,pie,set1,0,0,True,-3.0,0,6,non-aligned,non-aligned
20,study7Pie,16.0,11,25,1611,19,pie,set4,6,6,False,2.6147098441152083,6,0,end75,aligned
20,study7Pie,11.0,12,35,1612,31,pie,set2,4,4,False,2.0443941193584534,6,0,start0,aligned
20,study7Pie,6.0,13,50,1613,46,pie,set4,4,4,False,2.0443941193584534,4,0,start0,aligned
20,study7Pie,7.0,14,40,1614,36,pie,set2,4,4,False,2.0443941193584534,11,1,non-aligned,non-aligned
20,study7Pie,8.0,15,35,1615,29,pie,set3,6,6,False,2.6147098441152083,4,9,non-aligned,non-aligned
20,study7Pie,12.0,16,30,1616,26,pie,set3,4,4,False,2.0443941193584534,1,0,start0,aligned
20,study7Pie,7.0,17,40,1617,34,pie,set4,6,6,False,2.6147098441152083,9,0,start0,aligned
20,study7Pie,6.0,18,30,1618,23,pie,set2,7,7,False,2.8328900141647417,2,0,start0,aligned
20,study7Pie,5.0,19,50,1619,47,pie,set2,3,3,False,1.6438561897747246,3,0,start0,aligned
20,study7Pie,6.0,20,40,1620,35,pie,set3,5,5,False,2.357552004618084,10,0,start0,aligned
20,study7Pie,7.0,21,25,1621,22,pie,set1,3,3,False,1.6438561897747246,3,2,non-aligned,non-aligned
20,study7Pie,9.0,22,15,1622,18,pie,set1,-3,3,False,1.6438561897747246,7,1,non-aligned,non-aligned
20,study7Pie,5.0,23,10,1623,13,pie,set2,-3,3,False,1.6438561897747246,12,0,start0,aligned
20,study7Pie,6.0,24,40,1624,36,pie,set4,4,4,False,2.0443941193584534,11,0,start0,aligned
20,study7Pie,19.0,25,30,1625,29,pie,set2,1,1,False,0.16992500144231237,4,0,start0,aligned
20,study7Pie,4.0,26,50,1626,49,pie,set4,1,1,False,0.16992500144231237,1,0,start0,aligned
20,study7Pie,6.0,27,45,1627,38,pie,set4,7,7,False,2.8328900141647417,12,0,start0,aligned
20,study7Pie,5.0,28,35,1628,27,pie,set3,8,8,False,3.0223678130284544,2,6,non-aligned,non-aligned
20,study7Pie,8.0,29,45,1629,30,pie,set1,15,15,False,3.9188632372745946,5,8,non-aligned,non-aligned
20,study7Pie,8.0,30,20,1630,13,pie,set2,7,7,False,2.8328900141647417,12,6,non-aligned,non-aligned
20,study7Pie,7.0,31,15,1631,14,pie,set2,1,1,False,0.16992500144231237,11,0,start0,aligned
20,study7Pie,8.0,32,40,1632,39,pie,set2,1,1,False,0.16992500144231237,11,0,start0,aligned
20,study7Pie,11.0,33,48,1633,48,pie,set4,0,0,True,-3.0,2,2,non-aligned,non-aligned
20,study7Pie,9.0,34,46,1634,44,pie,set2,2,2,False,1.0874628412503393,6,0,start0,aligned
20,study7Pie,7.0,35,20,1635,11,pie,set4,9,9,False,3.189824558880017,11,0,start0,aligned
20,study7Pie,6.0,36,15,1636,12,pie,set4,3,3,False,1.6438561897747246,12,0,start0,aligned
20,study7Pie,7.0,37,25,1637,23,pie,set1,2,2,False,1.0874628412503393,2,3,non-aligned,non-aligned
20,study7Pie,11.0,38,40,1638,35,pie,set1,5,5,False,2.357552004618084,10,6,non-aligned,non-aligned
20,study7Pie,12.0,39,45,1639,45,pie,set2,0,0,True,-3.0,5,9,non-aligned,non-aligned
20,study7Pie,9.0,40,45,1640,43,pie,set2,2,2,False,1.0874628412503393,7,2,non-aligned,non-aligned
20,study7Pie,5.0,41,45,1641,43,pie,set2,2,2,False,1.0874628412503393,7,0,start0,aligned
20,study7Pie,8.0,42,45,1642,41,pie,set4,4,4,False,2.0443941193584534,9,0,start0,aligned
20,study7Pie,7.0,43,35,1643,28,pie,set3,7,7,False,2.8328900141647417,3,9,non-aligned,non-aligned
20,study7Pie,6.0,44,25,1644,18,pie,set1,7,7,False,2.8328900141647417,7,0,start0,aligned
20,study7Pie,5.0,45,25,1645,20,pie,set3,5,5,False,2.357552004618084,5,2,non-aligned,non-aligned
20,study7Pie,9.0,46,30,1646,24,pie,set2,6,6,False,2.6147098441152083,1,0,start0,aligned
20,study7Pie,5.0,47,30,1647,25,pie,set1,5,5,False,2.357552004618084,0,7,non-aligned,non-aligned
20,study7Pie,6.0,48,48,1648,45,pie,set4,3,3,False,1.6438561897747246,5,0,start0,aligned
20,study7Pie,6.0,49,20,1649,16,pie,set2,4,4,False,2.0443941193584534,9,0,start0,aligned
20,study7Pie,5.0,50,20,1650,15,pie,set1,5,5,False,2.357552004618084,10,0,start0,aligned
20,study7Pie,6.0,51,24,1651,21,pie,set1,3,3,False,1.6438561897747246,4,0,start0,aligned
20,study7Pie,5.0,52,25,1652,25,pie,set2,0,0,True,-3.0,0,0,start0,aligned
20,study7Pie,10.0,53,40,1653,37,pie,set4,3,3,False,1.6438561897747246,12,1,non-aligned,non-aligned
20,study7Pie,8.0,54,35,1654,31,pie,set1,4,4,False,2.0443941193584534,6,4,non-aligned,non-aligned
20,study7Pie,5.0,55,35,1655,26,pie,set4,9,9,False,3.189824558880017,1,1,non-aligned,non-aligned
20,study7Pie,6.0,56,25,1656,20,pie,set3,5,5,False,2.357552004618084,5,0,start0,aligned
20,study7Pie,15.0,57,36,1657,33,pie,set4,3,3,False,1.6438561897747246,8,4,non-aligned,non-aligned
20,study7Pie,10.0,58,20,1658,15,pie,set1,5,5,False,2.357552004618084,10,5,non-aligned,non-aligned
20,study7Pie,5.0,59,25,1659,17,pie,set1,8,8,False,3.0223678130284544,8,0,start0,aligned
20,study7Pie,6.0,60,45,1660,28,pie,set4,17,17,False,4.098032082960526,3,0,start0,aligned
20,study7Pie,7.0,61,40,1661,40,pie,set3,0,0,True,-3.0,10,2,non-aligned,non-aligned
20,study7Pie,4.0,62,25,1662,19,pie,set1,6,6,False,2.6147098441152083,6,0,start0,aligned
20,study7Pie,9.0,63,40,1663,30,pie,set4,10,10,False,3.3398500028846247,5,0,start0,aligned
20,study7Pie,16.0,64,48,1664,44,pie,set1,4,4,False,2.0443941193584534,6,2,non-aligned,non-aligned
20,study7Pie,8.0,65,40,1665,32,pie,set2,8,8,False,3.0223678130284544,7,0,start0,aligned
20,study7Pie,8.0,66,48,1666,48,pie,set4,0,0,True,-3.0,2,0,start0,aligned
20,study7Pie,9.0,67,45,1667,47,pie,set3,-2,2,False,1.0874628412503393,3,10,non-aligned,non-aligned
20,study7Pie,5.0,68,25,1668,11,pie,set2,14,14,False,3.820178962415188,11,2,non-aligned,non-aligned
20,study7Pie,20.0,69,38,1669,39,pie,set3,-1,1,False,0.16992500144231237,11,3,non-aligned,non-aligned
20,study7Pie,12.0,70,40,1670,40,pie,set4,0,0,True,-3.0,10,0,start0,aligned
20,study7Pie,6.0,71,25,1671,21,pie,set3,4,4,False,2.0443941193584534,4,2,non-aligned,non-aligned
20,study7Pie,19.0,72,35,1672,32,pie,set4,3,3,False,1.6438561897747246,7,7,non-aligned,non-aligned
20,study7Pie,8.0,73,48,1673,49,pie,set2,-1,1,False,0.16992500144231237,1,8,non-aligned,non-aligned
20,study7Pie,19.0,74,15,1674,12,pie,set4,3,3,False,1.6438561897747246,12,6,non-aligned,non-aligned
20,study7Pie,11.0,75,35,1675,38,pie,set3,-3,3,False,1.6438561897747246,12,3,non-aligned,non-aligned
20,study7Pie,5.0,76,35,1676,42,pie,set3,-7,7,False,2.8328900141647417,8,7,non-aligned,non-aligned
20,study7Pie,6.0,77,20,1677,17,pie,set4,3,3,False,1.6438561897747246,8,1,non-aligned,non-aligned
20,study7Pie,7.0,78,38,1678,34,pie,set4,4,4,False,2.0443941193584534,9,2,non-aligned,non-aligned
20,study7Pie,10.0,79,30,1679,22,pie,set4,8,8,False,3.0223678130284544,3,0,start0,aligned
6,study7Pie,10.0,0,30,480,27,pie,set2,3,3,False,1.6438561897747246,2,11,non-aligned,non-aligned
6,study7Pie,13.0,1,30,481,28,pie,set1,2,2,False,1.0874628412503393,3,10,non-aligned,non-aligned
6,study7Pie,8.0,2,15,482,12,pie,set1,3,3,False,1.6438561897747246,12,1,non-aligned,non-aligned
6,study7Pie,9.0,3,45,483,46,pie,set3,-1,1,False,0.16992500144231237,4,10,non-aligned,non-aligned
6,study7Pie,13.0,4,35,484,39,pie,set4,-4,4,False,2.0443941193584534,11,0,start0,aligned
6,study7Pie,8.0,5,40,485,41,pie,set4,-1,1,False,0.16992500144231237,9,4,non-aligned,non-aligned
6,study7Pie,10.0,6,40,486,41,pie,set1,-1,1,False,0.16992500144231237,9,0,start0,aligned
6,study7Pie,6.0,7,15,487,11,pie,set2,4,4,False,2.0443941193584534,11,2,non-aligned,non-aligned
6,study7Pie,7.0,8,40,488,43,pie,set2,-3,3,False,1.6438561897747246,7,0,start0,aligned
6,study7Pie,8.0,9,45,489,47,pie,set2,-2,2,False,1.0874628412503393,3,2,non-aligned,non-aligned
6,study7Pie,10.0,10,25,490,20,pie,set2,5,5,False,2.357552004618084,5,0,start75,aligned
6,study7Pie,8.0,11,40,491,39,pie,set1,1,1,False,0.16992500144231237,11,4,non-aligned,non-aligned
6,study7Pie,9.0,12,40,492,32,pie,set3,8,8,False,3.0223678130284544,7,2,non-aligned,non-aligned
6,study7Pie,9.0,13,20,493,16,pie,set1,4,4,False,2.0443941193584534,9,1,non-aligned,non-aligned
6,study7Pie,7.0,14,25,494,23,pie,set3,2,2,False,1.0874628412503393,2,0,start0,aligned
6,study7Pie,7.0,15,50,495,49,pie,set3,1,1,False,0.16992500144231237,1,1,non-aligned,non-aligned
6,study7Pie,6.0,16,40,496,38,pie,set4,2,2,False,1.0874628412503393,12,6,non-aligned,non-aligned
6,study7Pie,8.0,17,25,497,26,pie,set1,-1,1,False,0.16992500144231237,1,3,non-aligned,non-aligned
6,study7Pie,5.0,18,15,498,14,pie,set4,1,1,False,0.16992500144231237,11,6,non-aligned,non-aligned
6,study7Pie,6.0,19,45,499,48,pie,set4,-3,3,False,1.6438561897747246,2,2,non-aligned,non-aligned
6,study7Pie,7.0,20,25,500,23,pie,set2,2,2,False,1.0874628412503393,2,5,non-aligned,non-aligned
6,study7Pie,5.0,21,15,501,15,pie,set1,0,0,True,-3.0,10,0,start0,aligned
6,study7Pie,6.0,22,20,502,13,pie,set1,7,7,False,2.8328900141647417,12,0,start0,aligned
6,study7Pie,8.0,23,35,503,34,pie,set1,1,1,False,0.16992500144231237,9,0,start0,aligned
6,study7Pie,6.0,24,50,504,50,pie,set1,0,0,True,-3.0,0,6,non-aligned,non-aligned
6,study7Pie,6.0,25,30,505,31,pie,set4,-1,1,False,0.16992500144231237,6,0,start0,aligned
6,study7Pie,8.0,26,35,506,34,pie,set2,1,1,False,0.16992500144231237,9,2,non-aligned,non-aligned
6,study7Pie,7.0,27,35,507,33,pie,set2,2,2,False,1.0874628412503393,8,8,non-aligned,non-aligned
6,study7Pie,6.0,28,35,508,30,pie,set3,5,5,False,2.357552004618084,5,7,non-aligned,non-aligned
6,study7Pie,7.0,29,25,509,18,pie,set3,7,7,False,2.8328900141647417,7,0,start0,aligned
6,study7Pie,9.0,30,35,510,37,pie,set4,-2,2,False,1.0874628412503393,12,1,non-aligned,non-aligned
6,study7Pie,6.0,31,45,511,49,pie,set4,-4,4,False,2.0443941193584534,1,0,start0,aligned
6,study7Pie,7.0,32,45,512,42,pie,set1,3,3,False,1.6438561897747246,8,0,start0,aligned
6,study7Pie,7.0,33,45,513,44,pie,set2,1,1,False,0.16992500144231237,6,0,start0,aligned
6,study7Pie,7.0,34,30,514,28,pie,set4,2,2,False,1.0874628412503393,3,0,start0,aligned
6,study7Pie,7.0,35,25,515,19,pie,set3,6,6,False,2.6147098441152083,6,1,non-aligned,non-aligned
6,study7Pie,7.0,36,40,516,31,pie,set4,9,9,False,3.189824558880017,6,0,end50,aligned
6,study7Pie,8.0,37,20,517,18,pie,set3,2,2,False,1.0874628412503393,7,2,non-aligned,non-aligned
6,study7Pie,6.0,38,15,518,13,pie,set1,2,2,False,1.0874628412503393,12,6,non-aligned,non-aligned
6,study7Pie,7.0,39,45,519,44,pie,set2,1,1,False,0.16992500144231237,6,9,non-aligned,non-aligned
6,study7Pie,6.0,40,35,520,24,pie,set1,11,11,False,3.4757334309663976,1,5,non-aligned,non-aligned
6,study7Pie,9.0,41,25,521,25,pie,set3,0,0,True,-3.0,0,0,start0,aligned
6,study7Pie,5.0,42,35,522,33,pie,set4,2,2,False,1.0874628412503393,8,0,start0,aligned
6,study7Pie,6.0,43,25,523,21,pie,set3,4,4,False,2.0443941193584534,4,0,start0,aligned
6,study7Pie,5.0,44,25,524,21,pie,set1,4,4,False,2.0443941193584534,4,1,non-aligned,non-aligned
6,study7Pie,7.0,45,20,525,17,pie,set2,3,3,False,1.6438561897747246,8,0,start0,aligned
6,study7Pie,7.0,46,35,526,36,pie,set3,-1,1,False,0.16992500144231237,11,0,start0,aligned
6,study7Pie,7.0,47,35,527,30,pie,set2,5,5,False,2.357552004618084,5,0,start0,aligned
6,study7Pie,7.0,48,40,528,37,pie,set3,3,3,False,1.6438561897747246,12,0,start0,aligned
6,study7Pie,6.0,49,30,529,29,pie,set4,1,1,False,0.16992500144231237,4,3,non-aligned,non-aligned
6,study7Pie,5.0,50,25,530,19,pie,set4,6,6,False,2.6147098441152083,6,0,start0,aligned
6,study7Pie,4.0,51,25,531,22,pie,set4,3,3,False,1.6438561897747246,3,0,start75,aligned
6,study7Pie,6.0,52,30,532,32,pie,set2,-2,2,False,1.0874628412503393,7,0,start0,aligned
6,study7Pie,6.0,53,20,533,16,pie,set2,4,4,False,2.0443941193584534,9,0,start0,aligned
6,study7Pie,6.0,54,25,534,25,pie,set4,0,0,True,-3.0,0,0,start25,aligned
6,study7Pie,5.0,55,25,535,22,pie,set1,3,3,False,1.6438561897747246,3,0,start0,aligned
6,study7Pie,7.0,56,45,536,38,pie,set1,7,7,False,2.8328900141647417,12,0,start0,aligned
6,study7Pie,6.0,57,45,537,42,pie,set3,3,3,False,1.6438561897747246,8,7,non-aligned,non-aligned
6,study7Pie,6.0,58,45,538,45,pie,set2,0,0,True,-3.0,5,0,start0,aligned
6,study7Pie,6.0,59,35,539,35,pie,set3,0,0,True,-3.0,10,2,non-aligned,non-aligned
6,study7Pie,6.0,60,50,540,50,pie,set2,0,0,True,-3.0,0,0,start0,aligned
6,study7Pie,5.0,61,25,541,20,pie,set1,5,5,False,2.357552004618084,5,0,start0,aligned
6,study7Pie,5.0,62,25,542,24,pie,set4,1,1,False,0.16992500144231237,1,0,start0,aligned
6,study7Pie,6.0,63,40,543,40,pie,set3,0,0,True,-3.0,10,2,non-aligned,non-aligned
6,study7Pie,5.0,64,45,544,46,pie,set4,-1,1,False,0.16992500144231237,4,0,start0,aligned
6,study7Pie,6.0,65,15,545,12,pie,set1,3,3,False,1.6438561897747246,12,0,start0,aligned
6,study7Pie,7.0,66,25,546,27,pie,set1,-2,2,False,1.0874628412503393,2,0,start0,aligned
6,study7Pie,7.0,67,15,547,15,pie,set1,0,0,True,-3.0,10,5,non-aligned,non-aligned
6,study7Pie,8.0,68,47,548,48,pie,set2,-1,1,False,0.16992500144231237,2,0,start0,aligned
6,study7Pie,8.0,69,18,549,29,pie,set4,-11,11,False,3.4757334309663976,4,0,start0,aligned
6,study7Pie,8.0,70,42,550,45,pie,set1,-3,3,False,1.6438561897747246,5,2,non-aligned,non-aligned
6,study7Pie,6.0,71,15,551,11,pie,set3,4,4,False,2.0443941193584534,11,0,start0,aligned
6,study7Pie,6.0,72,20,552,14,pie,set3,6,6,False,2.6147098441152083,11,0,start0,aligned
6,study7Pie,8.0,73,22,553,17,pie,set2,5,5,False,2.357552004618084,8,5,non-aligned,non-aligned
6,study7Pie,8.0,74,25,554,26,pie,set1,-1,1,False,0.16992500144231237,1,0,start0,aligned
6,study7Pie,7.0,75,40,555,43,pie,set4,-3,3,False,1.6438561897747246,7,6,non-aligned,non-aligned
6,study7Pie,8.0,76,47,556,47,pie,set3,0,0,True,-3.0,3,0,start0,aligned
6,study7Pie,6.0,77,40,557,35,pie,set4,5,5,False,2.357552004618084,10,0,start0,aligned
6,study7Pie,10.0,78,40,558,36,pie,set2,4,4,False,2.0443941193584534,11,1,non-aligned,non-aligned
6,study7Pie,7.0,79,40,559,40,pie,set1,0,0,True,-3.0,10,0,start0,aligned
12,study7Pie,39.0,0,13,960,12,pie,set1,1,1,False,0.16992500144231237,12,0,start0,aligned
12,study7Pie,20.0,1,40,961,39,pie,set3,1,1,False,0.16992500144231237,11,3,non-aligned,non-aligned
12,study7Pie,9.0,2,40,962,37,pie,set3,3,3,False,1.6438561897747246,12,0,start25,aligned
12,study7Pie,23.0,3,40,963,32,pie,set4,8,8,False,3.0223678130284544,7,7,non-aligned,non-aligned
12,study7Pie,19.0,4,48,964,49,pie,set3,-1,1,False,0.16992500144231237,1,1,non-aligned,non-aligned
12,study7Pie,7.0,5,40,965,42,pie,set1,-2,2,False,1.0874628412503393,8,3,non-aligned,non-aligned
12,study7Pie,7.0,6,33,966,34,pie,set1,-1,1,False,0.16992500144231237,9,0,start0,aligned
12,study7Pie,7.0,7,40,967,43,pie,set2,-3,3,False,1.6438561897747246,7,2,non-aligned,non-aligned
12,study7Pie,7.0,8,30,968,15,pie,set1,15,15,False,3.9188632372745946,10,5,non-aligned,non-aligned
12,study7Pie,7.0,9,45,969,42,pie,set3,3,3,False,1.6438561897747246,8,0,start0,aligned
12,study7Pie,6.0,10,35,970,23,pie,set3,12,12,False,3.599912842187128,2,10,non-aligned,non-aligned
12,study7Pie,5.0,11,30,971,22,pie,set3,8,8,False,3.0223678130284544,3,0,start0,aligned
12,study7Pie,7.0,12,40,972,40,pie,set1,0,0,True,-3.0,10,0,start0,aligned
12,study7Pie,7.0,13,20,973,19,pie,set3,1,1,False,0.16992500144231237,6,0,start0,aligned
12,study7Pie,6.0,14,48,974,47,pie,set4,1,1,False,0.16992500144231237,3,10,non-aligned,non-aligned
12,study7Pie,7.0,15,30,975,28,pie,set4,2,2,False,1.0874628412503393,3,0,start0,aligned
12,study7Pie,7.0,16,33,976,32,pie,set3,1,1,False,0.16992500144231237,7,0,start0,aligned
12,study7Pie,8.0,17,25,977,27,pie,set1,-2,2,False,1.0874628412503393,2,2,non-aligned,non-aligned
12,study7Pie,5.0,18,33,978,37,pie,set2,-4,4,False,2.0443941193584534,12,0,start0,aligned
12,study7Pie,4.0,19,45,979,46,pie,set4,-1,1,False,0.16992500144231237,4,0,start0,aligned
12,study7Pie,4.0,20,25,980,25,pie,set4,0,0,True,-3.0,0,0,start0,aligned
12,study7Pie,5.0,21,22,981,21,pie,set1,1,1,False,0.16992500144231237,4,1,non-aligned,non-aligned
12,study7Pie,4.0,22,30,982,31,pie,set4,-1,1,False,0.16992500144231237,6,0,start0,aligned
12,study7Pie,4.0,23,30,983,31,pie,set1,-1,1,False,0.16992500144231237,6,4,non-aligned,non-aligned
12,study7Pie,10.0,24,48,984,48,pie,set4,0,0,True,-3.0,2,2,non-aligned,non-aligned
12,study7Pie,6.0,25,48,985,47,pie,set3,1,1,False,0.16992500144231237,3,0,start0,aligned
12,study7Pie,5.0,26,45,986,48,pie,set2,-3,3,False,1.6438561897747246,2,0,start0,aligned
12,study7Pie,4.0,27,50,987,50,pie,set2,0,0,True,-3.0,0,0,start0,aligned
12,study7Pie,4.0,28,20,988,13,pie,set3,7,7,False,2.8328900141647417,12,0,start0,aligned
12,study7Pie,4.0,29,20,989,22,pie,set4,-2,2,False,1.0874628412503393,3,0,start75,aligned
12,study7Pie,4.0,30,20,990,17,pie,set4,3,3,False,1.6438561897747246,8,1,non-aligned,non-aligned
12,study7Pie,6.0,31,30,991,30,pie,set1,0,0,True,-3.0,5,0,start0,aligned
12,study7Pie,8.0,32,40,992,39,pie,set4,1,1,False,0.16992500144231237,11,0,start0,aligned
12,study7Pie,9.0,33,40,993,41,pie,set1,-1,1,False,0.16992500144231237,9,6,non-aligned,non-aligned
12,study7Pie,6.0,34,20,994,19,pie,set1,1,1,False,0.16992500144231237,6,8,non-aligned,non-aligned
12,study7Pie,4.0,35,30,995,33,pie,set2,-3,3,False,1.6438561897747246,8,8,non-aligned,non-aligned
12,study7Pie,5.0,36,40,996,40,pie,set3,0,0,True,-3.0,10,2,non-aligned,non-aligned
12,study7Pie,5.0,37,24,997,24,pie,set2,0,0,True,-3.0,1,0,start0,aligned
12,study7Pie,3.0,38,25,998,28,pie,set4,-3,3,False,1.6438561897747246,3,5,non-aligned,non-aligned
12,study7Pie,3.0,39,20,999,16,pie,set4,4,4,False,2.0443941193584534,9,0,start0,aligned
12,study7Pie,8.0,40,45,1000,44,pie,set4,1,1,False,0.16992500144231237,6,2,non-aligned,non-aligned
12,study7Pie,3.0,41,45,1001,45,pie,set2,0,0,True,-3.0,5,9,non-aligned,non-aligned
12,study7Pie,5.0,42,30,1002,29,pie,set3,1,1,False,0.16992500144231237,4,9,non-aligned,non-aligned
12,study7Pie,4.0,43,20,1003,16,pie,set3,4,4,False,2.0443941193584534,9,3,non-aligned,non-aligned
12,study7Pie,4.0,44,33,1004,35,pie,set3,-2,2,False,1.0874628412503393,10,0,start0,aligned
12,study7Pie,5.0,45,23,1005,23,pie,set1,0,0,True,-3.0,2,0,start0,aligned
12,study7Pie,6.0,46,26,1006,27,pie,set3,-1,1,False,0.16992500144231237,2,0,start0,aligned
12,study7Pie,3.0,47,26,1007,29,pie,set1,-3,3,False,1.6438561897747246,4,0,start0,aligned
12,study7Pie,4.0,48,40,1008,38,pie,set3,2,2,False,1.0874628412503393,12,3,non-aligned,non-aligned
12,study7Pie,5.0,49,48,1009,49,pie,set1,-1,1,False,0.16992500144231237,1,0,start0,aligned
12,study7Pie,4.0,50,48,1010,45,pie,set2,3,3,False,1.6438561897747246,5,0,start0,aligned
12,study7Pie,3.0,51,20,1011,21,pie,set3,-1,1,False,0.16992500144231237,4,0,start0,aligned
12,study7Pie,9.0,52,45,1012,46,pie,set3,-1,1,False,0.16992500144231237,4,10,non-aligned,non-aligned
12,study7Pie,4.0,53,15,1013,12,pie,set3,3,3,False,1.6438561897747246,12,1,non-aligned,non-aligned
12,study7Pie,4.0,54,42,1014,43,pie,set1,-1,1,False,0.16992500144231237,7,0,start0,aligned
12,study7Pie,4.0,55,20,1015,20,pie,set1,0,0,True,-3.0,5,0,start75,aligned
12,study7Pie,4.0,56,20,1016,15,pie,set2,5,5,False,2.357552004618084,10,0,start0,aligned
12,study7Pie,3.0,57,20,1017,11,pie,set3,9,9,False,3.189824558880017,11,0,start0,aligned
12,study7Pie,6.0,58,26,1018,26,pie,set1,0,0,True,-3.0,1,0,start0,aligned
12,study7Pie,5.0,59,50,1019,50,pie,set1,0,0,True,-3.0,0,6,non-aligned,non-aligned
12,study7Pie,4.0,60,40,1020,36,pie,set4,4,4,False,2.0443941193584534,11,0,start0,aligned
12,study7Pie,11.0,61,42,1021,41,pie,set3,1,1,False,0.16992500144231237,9,0,start0,aligned
12,study7Pie,3.0,62,20,1022,20,pie,set2,0,0,True,-3.0,5,0,start0,aligned
12,study7Pie,3.0,63,30,1023,33,pie,set3,-3,3,False,1.6438561897747246,8,0,start0,aligned
12,study7Pie,4.0,64,42,1024,36,pie,set1,6,6,False,2.6147098441152083,11,3,non-aligned,non-aligned
12,study7Pie,3.0,65,25,1025,24,pie,set4,1,1,False,0.16992500144231237,1,9,non-aligned,non-aligned
12,study7Pie,4.0,66,20,1026,17,pie,set4,3,3,False,1.6438561897747246,8,0,start0,aligned
12,study7Pie,4.0,67,20,1027,14,pie,set1,6,6,False,2.6147098441152083,11,0,start0,aligned
12,study7Pie,6.0,68,15,1028,13,pie,set1,2,2,False,1.0874628412503393,12,6,non-aligned,non-aligned
12,study7Pie,4.0,69,25,1029,26,pie,set3,-1,1,False,0.16992500144231237,1,3,non-aligned,non-aligned
12,study7Pie,3.0,70,40,1030,38,pie,set3,2,2,False,1.0874628412503393,12,0,start0,aligned
12,study7Pie,4.0,71,20,1031,14,pie,set2,6,6,False,2.6147098441152083,11,4,non-aligned,non-aligned
12,study7Pie,3.0,72,25,1032,25,pie,set2,0,0,True,-3.0,0,8,non-aligned,non-aligned
12,study7Pie,3.0,73,20,1033,18,pie,set3,2,2,False,1.0874628412503393,7,0,start0,aligned
12,study7Pie,3.0,74,15,1034,11,pie,set3,4,4,False,2.0443941193584534,11,5,non-aligned,non-aligned
12,study7Pie,4.0,75,30,1035,34,pie,set3,-4,4,False,2.0443941193584534,9,3,non-aligned,non-aligned
12,study7Pie,6.0,76,45,1036,44,pie,set1,1,1,False,0.16992500144231237,6,0,start0,aligned
12,study7Pie,4.0,77,28,1037,30,pie,set1,-2,2,False,1.0874628412503393,5,8,non-aligned,non-aligned
12,study7Pie,4.0,78,20,1038,18,pie,set2,2,2,False,1.0874628412503393,7,1,non-aligned,non-aligned
12,study7Pie,4.0,79,40,1039,35,pie,set1,5,5,False,2.357552004618084,10,6,non-aligned,non-aligned
29,study7Pie,20.0,0,26,2320,24,pie,set3,2,2,False,1.0874628412503393,1,8,non-aligned,non-aligned
29,study7Pie,303.0,1,13,2321,12,pie,set2,1,1,False,0.16992500144231237,12,1,non-aligned,non-aligned
29,study7Pie,78.0,2,46,2322,46,pie,set2,0,0,True,-3.0,4,0,start0,aligned
29,study7Pie,11.0,3,38,2323,39,pie,set3,-1,1,False,0.16992500144231237,11,3,non-aligned,non-aligned
29,study7Pie,20.0,4,25,2324,22,pie,set2,3,3,False,1.6438561897747246,3,9,non-aligned,non-aligned
29,study7Pie,164.0,5,32,2325,33,pie,set4,-1,1,False,0.16992500144231237,8,4,non-aligned,non-aligned
29,study7Pie,169.0,6,15,2326,19,pie,set1,-4,4,False,2.0443941193584534,6,8,non-aligned,non-aligned
29,study7Pie,50.0,7,24,2327,24,pie,set3,0,0,True,-3.0,1,0,start0,aligned
29,study7Pie,6.0,8,31,2328,31,pie,set3,0,0,True,-3.0,6,2,non-aligned,non-aligned
29,study7Pie,4.0,9,20,2329,22,pie,set4,-2,2,False,1.0874628412503393,3,0,start0,aligned
29,study7Pie,816.0,10,33,2330,30,pie,set2,3,3,False,1.6438561897747246,5,4,non-aligned,non-aligned
29,study7Pie,12.0,11,13,2331,16,pie,set2,-3,3,False,1.6438561897747246,9,2,non-aligned,non-aligned
29,study7Pie,39.0,12,19,2332,20,pie,set2,-1,1,False,0.16992500144231237,5,0,start0,aligned
29,study7Pie,7.0,13,36,2333,37,pie,set3,-1,1,False,0.16992500144231237,12,0,start25,aligned
29,study7Pie,6.0,14,49,2334,48,pie,set2,1,1,False,0.16992500144231237,2,0,start0,aligned
29,study7Pie,5.0,15,45,2335,42,pie,set2,3,3,False,1.6438561897747246,8,0,start0,aligned
29,study7Pie,4.0,16,24,2336,23,pie,set3,1,1,False,0.16992500144231237,2,0,start0,aligned
29,study7Pie,262.0,17,21,2337,20,pie,set2,1,1,False,0.16992500144231237,5,0,start75,aligned
29,study7Pie,33.0,18,48,2338,47,pie,set2,1,1,False,0.16992500144231237,3,2,non-aligned,non-aligned
29,study7Pie,12.0,19,29,2339,30,pie,set2,-1,1,False,0.16992500144231237,5,0,start0,aligned
29,study7Pie,452.0,20,14,2340,17,pie,set1,-3,3,False,1.6438561897747246,8,0,start0,aligned
29,study7Pie,9.0,21,44,2341,44,pie,set3,0,0,True,-3.0,6,8,non-aligned,non-aligned
29,study7Pie,13.0,22,44,2342,37,pie,set4,7,7,False,2.8328900141647417,12,0,start0,aligned
29,study7Pie,10.0,23,16,2343,16,pie,set1,0,0,True,-3.0,9,0,start0,aligned
29,study7Pie,100.0,24,34,2344,38,pie,set1,-4,4,False,2.0443941193584534,12,1,non-aligned,non-aligned
29,study7Pie,5.0,25,41,2345,41,pie,set2,0,0,True,-3.0,9,4,non-aligned,non-aligned
29,study7Pie,14.0,26,40,2346,36,pie,set3,4,4,False,2.0443941193584534,11,3,non-aligned,non-aligned
29,study7Pie,4.0,27,25,2347,26,pie,set2,-1,1,False,0.16992500144231237,1,10,non-aligned,non-aligned
29,study7Pie,6.0,28,47,2348,43,pie,set3,4,4,False,2.0443941193584534,7,0,start0,aligned
29,study7Pie,40.0,29,50,2349,49,pie,set2,1,1,False,0.16992500144231237,1,8,non-aligned,non-aligned
29,study7Pie,5.0,30,40,2350,38,pie,set4,2,2,False,1.0874628412503393,12,0,start0,aligned
29,study7Pie,12.0,31,27,2351,28,pie,set4,-1,1,False,0.16992500144231237,3,0,start0,aligned
29,study7Pie,52.0,32,38,2352,40,pie,set3,-2,2,False,1.0874628412503393,10,2,non-aligned,non-aligned
29,study7Pie,6.0,33,28,2353,29,pie,set1,-1,1,False,0.16992500144231237,4,2,non-aligned,non-aligned
29,study7Pie,31.0,34,29,2354,33,pie,set4,-4,4,False,2.0443941193584534,8,0,start0,aligned
29,study7Pie,5.0,35,43,2355,46,pie,set2,-3,3,False,1.6438561897747246,4,9,non-aligned,non-aligned
29,study7Pie,34.0,36,47,2356,45,pie,set3,2,2,False,1.0874628412503393,5,0,start0,aligned
29,study7Pie,6.0,37,49,2357,49,pie,set4,0,0,True,-3.0,1,0,start0,aligned
29,study7Pie,6.0,38,13,2358,19,pie,set4,-6,6,False,2.6147098441152083,6,0,start0,aligned
29,study7Pie,3.0,39,26,2359,26,pie,set3,0,0,True,-3.0,1,0,start0,aligned
29,study7Pie,4.0,40,49,2360,50,pie,set2,-1,1,False,0.16992500144231237,0,4,non-aligned,non-aligned
29,study7Pie,5.0,41,38,2361,35,pie,set1,3,3,False,1.6438561897747246,10,6,non-aligned,non-aligned
29,study7Pie,22.0,42,13,2362,12,pie,set3,1,1,False,0.16992500144231237,12,0,start0,aligned
29,study7Pie,4.0,43,48,2363,47,pie,set4,1,1,False,0.16992500144231237,3,0,start0,aligned
29,study7Pie,23.0,44,14,2364,15,pie,set1,-1,1,False,0.16992500144231237,10,0,start0,aligned
29,study7Pie,4.0,45,50,2365,50,pie,set4,0,0,True,-3.0,0,0,start0,aligned
29,study7Pie,23.0,46,27,2366,29,pie,set1,-2,2,False,1.0874628412503393,4,0,start0,aligned
29,study7Pie,4.0,47,24,2367,28,pie,set2,-4,4,False,2.0443941193584534,3,8,non-aligned,non-aligned
29,study7Pie,5.0,48,46,2368,43,pie,set1,3,3,False,1.6438561897747246,7,2,non-aligned,non-aligned
29,study7Pie,10.0,49,36,2369,40,pie,set1,-4,4,False,2.0443941193584534,10,0,start0,aligned
29,study7Pie,59.0,50,27,2370,32,pie,set4,-5,5,False,2.357552004618084,7,7,non-aligned,non-aligned
29,study7Pie,6.0,51,22,2371,21,pie,set4,1,1,False,0.16992500144231237,4,0,start0,aligned
29,study7Pie,36.0,52,10,2372,15,pie,set1,-5,5,False,2.357552004618084,10,5,non-aligned,non-aligned
29,study7Pie,6.0,53,14,2373,21,pie,set4,-7,7,False,2.8328900141647417,4,2,non-aligned,non-aligned
29,study7Pie,5.0,54,25,2374,25,pie,set3,0,0,True,-3.0,0,0,start0,aligned
29,study7Pie,5.0,55,46,2375,48,pie,set1,-2,2,False,1.0874628412503393,2,9,non-aligned,non-aligned
29,study7Pie,7.0,56,38,2376,35,pie,set2,3,3,False,1.6438561897747246,10,0,start0,aligned
29,study7Pie,26.0,57,26,2377,27,pie,set3,-1,1,False,0.16992500144231237,2,6,non-aligned,non-aligned
29,study7Pie,14.0,58,20,2378,18,pie,set3,2,2,False,1.0874628412503393,7,0,start0,aligned
29,study7Pie,13.0,59,44,2379,44,pie,set3,0,0,True,-3.0,6,0,start0,aligned
29,study7Pie,5.0,60,27,2380,25,pie,set1,2,2,False,1.0874628412503393,0,7,non-aligned,non-aligned
29,study7Pie,47.0,61,20,2381,23,pie,set2,-3,3,False,1.6438561897747246,2,5,non-aligned,non-aligned
29,study7Pie,12.0,62,39,2382,39,pie,set2,0,0,True,-3.0,11,0,start0,aligned
29,study7Pie,22.0,63,46,2383,41,pie,set1,5,5,False,2.357552004618084,9,0,start0,aligned
29,study7Pie,31.0,64,9,2384,13,pie,set1,-4,4,False,2.0443941193584534,12,6,non-aligned,non-aligned
29,study7Pie,4.0,65,28,2385,32,pie,set4,-4,4,False,2.0443941193584534,7,0,start0,aligned
29,study7Pie,14.0,66,14,2386,14,pie,set1,0,0,True,-3.0,11,5,non-aligned,non-aligned
29,study7Pie,12.0,67,55,2387,45,pie,set1,10,10,False,3.3398500028846247,5,2,non-aligned,non-aligned
29,study7Pie,9.0,68,18,2388,17,pie,set3,1,1,False,0.16992500144231237,8,3,non-aligned,non-aligned
29,study7Pie,31.0,69,11,2389,11,pie,set1,0,0,True,-3.0,11,4,non-aligned,non-aligned
29,study7Pie,4.0,70,39,2390,34,pie,set4,5,5,False,2.357552004618084,9,0,start0,aligned
29,study7Pie,5.0,71,21,2391,18,pie,set1,3,3,False,1.6438561897747246,7,1,non-aligned,non-aligned
29,study7Pie,4.0,72,16,2392,13,pie,set4,3,3,False,1.6438561897747246,12,0,start0,aligned
29,study7Pie,7.0,73,42,2393,42,pie,set1,0,0,True,-3.0,8,3,non-aligned,non-aligned
29,study7Pie,4.0,74,8,2394,11,pie,set1,-3,3,False,1.6438561897747246,11,0,start0,aligned
29,study7Pie,4.0,75,40,2395,36,pie,set3,4,4,False,2.0443941193584534,11,0,start0,aligned
29,study7Pie,4.0,76,28,2396,27,pie,set3,1,1,False,0.16992500144231237,2,0,start0,aligned
29,study7Pie,6.0,77,13,2397,14,pie,set3,-1,1,False,0.16992500144231237,11,0,start0,aligned
29,study7Pie,3.0,78,34,2398,31,pie,set3,3,3,False,1.6438561897747246,6,0,start0,aligned
29,study7Pie,6.0,79,39,2399,34,pie,set2,5,5,False,2.357552004618084,9,2,non-aligned,non-aligned
35,study7Pie,10.0,0,35,2800,28,pie,set4,7,7,False,2.8328900141647417,3,0,start0,aligned
35,study7Pie,5.0,1,45,2801,36,pie,set1,9,9,False,3.189824558880017,11,3,non-aligned,non-aligned
35,study7Pie,7.0,2,27,2802,25,pie,set1,2,2,False,1.0874628412503393,0,7,non-aligned,non-aligned
35,study7Pie,8.0,3,46,2803,42,pie,set3,4,4,False,2.0443941193584534,8,0,start0,aligned
35,study7Pie,11.0,4,46,2804,35,pie,set2,11,11,False,3.4757334309663976,10,3,non-aligned,non-aligned
35,study7Pie,13.0,5,49,2805,48,pie,set2,1,1,False,0.16992500144231237,2,0,start0,aligned
35,study7Pie,5.0,6,47,2806,42,pie,set1,5,5,False,2.357552004618084,8,3,non-aligned,non-aligned
35,study7Pie,11.0,7,31,2807,24,pie,set4,7,7,False,2.8328900141647417,1,0,start0,aligned
35,study7Pie,5.0,8,46,2808,45,pie,set4,1,1,False,0.16992500144231237,5,0,start0,aligned
35,study7Pie,6.0,9,47,2809,45,pie,set2,2,2,False,1.0874628412503393,5,9,non-aligned,non-aligned
35,study7Pie,5.0,10,30,2810,23,pie,set3,7,7,False,2.8328900141647417,2,0,start0,aligned
35,study7Pie,5.0,11,46,2811,47,pie,set1,-1,1,False,0.16992500144231237,3,2,non-aligned,non-aligned
35,study7Pie,6.0,12,31,2812,28,pie,set2,3,3,False,1.6438561897747246,3,8,non-aligned,non-aligned
35,study7Pie,6.0,13,24,2813,20,pie,set2,4,4,False,2.0443941193584534,5,0,start0,aligned
35,study7Pie,8.0,14,49,2814,49,pie,set4,0,0,True,-3.0,1,0,start0,aligned
35,study7Pie,7.0,15,20,2815,19,pie,set1,1,1,False,0.16992500144231237,6,8,non-aligned,non-aligned
35,study7Pie,7.0,16,37,2816,34,pie,set1,3,3,False,1.6438561897747246,9,6,non-aligned,non-aligned
35,study7Pie,7.0,17,20,2817,16,pie,set2,4,4,False,2.0443941193584534,9,0,start0,aligned
35,study7Pie,6.0,18,21,2818,17,pie,set4,4,4,False,2.0443941193584534,8,1,non-aligned,non-aligned
35,study7Pie,18.0,19,30,2819,27,pie,set4,3,3,False,1.6438561897747246,2,3,non-aligned,non-aligned
35,study7Pie,39.0,20,46,2820,44,pie,set3,2,2,False,1.0874628412503393,6,8,non-aligned,non-aligned
35,study7Pie,8.0,21,19,2821,14,pie,set1,5,5,False,2.357552004618084,11,0,start0,aligned
35,study7Pie,8.0,22,35,2822,30,pie,set3,5,5,False,2.357552004618084,5,7,non-aligned,non-aligned
35,study7Pie,13.0,23,21,2823,18,pie,set3,3,3,False,1.6438561897747246,7,2,non-aligned,non-aligned
35,study7Pie,57.0,24,40,2824,34,pie,set4,6,6,False,2.6147098441152083,9,0,start0,aligned
35,study7Pie,16.0,25,41,2825,31,pie,set2,10,10,False,3.3398500028846247,6,0,start0,aligned
35,study7Pie,9.0,26,43,2826,30,pie,set2,13,13,False,3.7142455176661224,5,0,start0,aligned
35,study7Pie,11.0,27,40,2827,33,pie,set2,7,7,False,2.8328900141647417,8,8,non-aligned,non-aligned
35,study7Pie,21.0,28,40,2828,32,pie,set1,8,8,False,3.0223678130284544,7,0,start0,aligned
35,study7Pie,12.0,29,43,2829,38,pie,set4,5,5,False,2.357552004618084,12,0,start0,aligned
35,study7Pie,9.0,30,19,2830,13,pie,set2,6,6,False,2.6147098441152083,12,0,start0,aligned
35,study7Pie,9.0,31,43,2831,37,pie,set1,6,6,False,2.6147098441152083,12,6,non-aligned,non-aligned
35,study7Pie,8.0,32,19,2832,13,pie,set1,6,6,False,2.6147098441152083,12,6,non-aligned,non-aligned
35,study7Pie,7.0,33,46,2833,46,pie,set2,0,0,True,-3.0,4,9,non-aligned,non-aligned
35,study7Pie,19.0,34,46,2834,40,pie,set3,6,6,False,2.6147098441152083,10,0,start0,aligned
35,study7Pie,7.0,35,35,2835,29,pie,set4,6,6,False,2.6147098441152083,4,3,non-aligned,non-aligned
35,study7Pie,6.0,36,43,2836,36,pie,set1,7,7,False,2.8328900141647417,11,0,start0,aligned
35,study7Pie,7.0,37,50,2837,50,pie,set3,0,0,True,-3.0,0,0,start0,aligned
35,study7Pie,15.0,38,39,2838,31,pie,set3,8,8,False,3.0223678130284544,6,2,non-aligned,non-aligned
35,study7Pie,7.0,39,29,2839,24,pie,set3,5,5,False,2.357552004618084,1,8,non-aligned,non-aligned
35,study7Pie,7.0,40,19,2840,12,pie,set4,7,7,False,2.8328900141647417,12,6,non-aligned,non-aligned
35,study7Pie,8.0,41,22,2841,15,pie,set2,7,7,False,2.8328900141647417,10,0,start0,aligned
35,study7Pie,11.0,42,25,2842,22,pie,set1,3,3,False,1.6438561897747246,3,2,non-aligned,non-aligned
35,study7Pie,66.0,43,28,2843,21,pie,set2,7,7,False,2.8328900141647417,4,6,non-aligned,non-aligned
35,study7Pie,44.0,44,45,2844,40,pie,set2,5,5,False,2.357552004618084,10,1,non-aligned,non-aligned
35,study7Pie,8.0,45,19,2845,11,pie,set1,8,8,False,3.0223678130284544,11,4,non-aligned,non-aligned
35,study7Pie,10.0,46,40,2846,35,pie,set3,5,5,False,2.357552004618084,10,0,start0,aligned
35,study7Pie,6.0,47,50,2847,50,pie,set3,0,0,True,-3.0,0,5,non-aligned,non-aligned
35,study7Pie,8.0,48,49,2848,49,pie,set1,0,0,True,-3.0,1,8,non-aligned,non-aligned
35,study7Pie,188.0,49,46,2849,44,pie,set4,2,2,False,1.0874628412503393,6,0,start0,aligned
35,study7Pie,14.0,50,30,2850,22,pie,set1,8,8,False,3.0223678130284544,3,0,start0,aligned
35,study7Pie,6.0,51,40,2851,33,pie,set3,7,7,False,2.8328900141647417,8,0,start0,aligned
35,study7Pie,5.0,52,43,2852,38,pie,set4,5,5,False,2.357552004618084,12,6,non-aligned,non-aligned
35,study7Pie,9.0,53,30,2853,25,pie,set3,5,5,False,2.357552004618084,0,0,start0,aligned
35,study7Pie,6.0,54,22,2854,20,pie,set3,2,2,False,1.0874628412503393,5,2,non-aligned,non-aligned
35,study7Pie,5.0,55,46,2855,39,pie,set4,7,7,False,2.8328900141647417,11,1,non-aligned,non-aligned
35,study7Pie,11.0,56,18,2856,15,pie,set3,3,3,False,1.6438561897747246,10,3,non-aligned,non-aligned
35,study7Pie,12.0,57,45,2857,41,pie,set1,4,4,False,2.0443941193584534,9,0,start0,aligned
35,study7Pie,5.0,58,19,2858,12,pie,set3,7,7,False,2.8328900141647417,12,0,start0,aligned
35,study7Pie,18.0,59,24,2859,19,pie,set3,5,5,False,2.357552004618084,6,0,start0,aligned
35,study7Pie,4.0,60,20,2860,14,pie,set1,6,6,False,2.6147098441152083,11,5,non-aligned,non-aligned
35,study7Pie,4.0,61,48,2861,48,pie,set1,0,0,True,-3.0,2,9,non-aligned,non-aligned
35,study7Pie,5.0,62,46,2862,43,pie,set3,3,3,False,1.6438561897747246,7,0,start0,aligned
35,study7Pie,6.0,63,32,2863,26,pie,set2,6,6,False,2.6147098441152083,1,0,start0,aligned
35,study7Pie,5.0,64,17,2864,11,pie,set4,6,6,False,2.6147098441152083,11,0,start0,aligned
35,study7Pie,6.0,65,35,2865,32,pie,set4,3,3,False,1.6438561897747246,7,7,non-aligned,non-aligned
35,study7Pie,7.0,66,29,2866,26,pie,set2,3,3,False,1.6438561897747246,1,10,non-aligned,non-aligned
35,study7Pie,5.0,67,45,2867,39,pie,set4,6,6,False,2.6147098441152083,11,0,start0,aligned
35,study7Pie,6.0,68,21,2868,16,pie,set2,5,5,False,2.357552004618084,9,2,non-aligned,non-aligned
35,study7Pie,6.0,69,28,2869,23,pie,set1,5,5,False,2.357552004618084,2,3,non-aligned,non-aligned
35,study7Pie,8.0,70,41,2870,37,pie,set1,4,4,False,2.0443941193584534,12,0,start0,aligned
35,study7Pie,7.0,71,20,2871,17,pie,set3,3,3,False,1.6438561897747246,8,0,start0,aligned
35,study7Pie,5.0,72,45,2872,41,pie,set1,4,4,False,2.0443941193584534,9,6,non-aligned,non-aligned
35,study7Pie,5.0,73,47,2873,47,pie,set3,0,0,True,-3.0,3,0,start0,aligned
35,study7Pie,6.0,74,47,2874,46,pie,set1,1,1,False,0.16992500144231237,4,0,start0,aligned
35,study7Pie,5.0,75,37,2875,29,pie,set2,8,8,False,3.0223678130284544,4,0,start0,aligned
35,study7Pie,6.0,76,35,2876,27,pie,set3,8,8,False,3.0223678130284544,2,0,start0,aligned
35,study7Pie,8.0,77,23,2877,18,pie,set2,5,5,False,2.357552004618084,7,0,start0,aligned
35,study7Pie,6.0,78,48,2878,43,pie,set3,5,5,False,2.357552004618084,7,3,non-aligned,non-aligned
35,study7Pie,6.0,79,29,2879,21,pie,set3,8,8,False,3.0223678130284544,4,0,start0,aligned
