userID,userSet,responseTimeSeconds,questionOrder,userResponse,questionID,correctResponse,chartType,questionSet,error,absDiff,correct,logError,distToHalfQuarter,distToHorizontalVertical,alignmentType,alignment
31,study7Line,13.0,0,15,2480,15,stackbar,set4,0,0,True,-3.0,10,0,start0,aligned
31,study7Line,14.0,1,20,2481,20,stackbar,set1,0,0,True,-3.0,5,0,start75,aligned
31,study7Line,9.0,2,25,2482,31,stackbar,set1,-6,6,False,2.6147098441152083,6,4,non-aligned,non-aligned
31,study7Line,11.0,3,15,2483,20,stackbar,set4,-5,5,False,2.357552004618084,5,0,start0,aligned
31,study7Line,11.0,4,45,2484,44,stackbar,set4,1,1,False,0.16992500144231237,6,0,start0,aligned
31,study7Line,21.0,5,35,2485,45,stackbar,set3,-10,10,False,3.3398500028846247,5,7,non-aligned,non-aligned
31,study7Line,8.0,6,45,2486,46,stackbar,set3,-1,1,False,0.16992500144231237,4,0,start0,aligned
31,study7Line,12.0,7,10,2487,13,stackbar,set4,-3,3,False,1.6438561897747246,12,0,start0,aligned
31,study7Line,17.0,8,35,2488,37,stackbar,set3,-2,2,False,1.0874628412503393,12,0,start0,aligned
31,study7Line,11.0,9,30,2489,34,stackbar,set1,-4,4,False,2.0443941193584534,9,6,non-aligned,non-aligned
31,study7Line,17.0,10,50,2490,50,stackbar,set3,0,0,True,-3.0,0,5,non-aligned,non-aligned
31,study7Line,13.0,11,15,2491,17,stackbar,set4,-2,2,False,1.0874628412503393,8,1,non-aligned,non-aligned
31,study7Line,7.0,12,10,2492,14,stackbar,set2,-4,4,False,2.0443941193584534,11,4,non-aligned,non-aligned
31,study7Line,6.0,13,10,2493,17,stackbar,set2,-7,7,False,2.8328900141647417,8,0,start0,aligned
31,study7Line,8.0,14,10,2494,12,stackbar,set1,-2,2,False,1.0874628412503393,12,1,non-aligned,non-aligned
31,study7Line,8.0,15,25,2495,44,stackbar,set4,-19,19,False,4.257387842692652,6,2,non-aligned,non-aligned
31,study7Line,11.0,16,20,2496,19,stackbar,set2,1,1,False,0.16992500144231237,6,0,start0,aligned
31,study7Line,12.0,17,20,2497,21,stackbar,set1,-1,1,False,0.16992500144231237,4,0,start0,aligned
31,study7Line,8.0,18,10,2498,11,stackbar,set1,-1,1,False,0.16992500144231237,11,0,start0,aligned
31,study7Line,9.0,19,27,2499,27,stackbar,set2,0,0,True,-3.0,2,0,start0,aligned
31,study7Line,7.0,20,10,2500,11,stackbar,set1,-1,1,False,0.16992500144231237,11,4,non-aligned,non-aligned
31,study7Line,13.0,21,40,2501,36,stackbar,set4,4,4,False,2.0443941193584534,11,0,start0,aligned
31,study7Line,17.0,22,13,2502,14,stackbar,set3,-1,1,False,0.16992500144231237,11,0,start0,aligned
31,study7Line,13.0,23,23,2503,23,stackbar,set3,0,0,True,-3.0,2,0,start0,aligned
31,study7Line,12.0,24,33,2504,36,stackbar,set3,-3,3,False,1.6438561897747246,11,3,non-aligned,non-aligned
31,study7Line,11.0,25,35,2505,33,stackbar,set3,2,2,False,1.0874628412503393,8,0,start0,aligned
31,study7Line,19.0,26,20,2506,15,stackbar,set2,5,5,False,2.357552004618084,10,4,non-aligned,non-aligned
31,study7Line,18.0,27,35,2507,38,stackbar,set1,-3,3,False,1.6438561897747246,12,1,non-aligned,non-aligned
31,study7Line,9.0,28,25,2508,27,stackbar,set4,-2,2,False,1.0874628412503393,2,3,non-aligned,non-aligned
31,study7Line,9.0,29,50,2509,49,stackbar,set3,1,1,False,0.16992500144231237,1,1,non-aligned,non-aligned
31,study7Line,12.0,30,30,2510,33,stackbar,set4,-3,3,False,1.6438561897747246,8,4,non-aligned,non-aligned
31,study7Line,7.0,31,26,2511,26,stackbar,set1,0,0,True,-3.0,1,0,start0,aligned
31,study7Line,11.0,32,50,2512,46,stackbar,set3,4,4,False,2.0443941193584534,4,10,non-aligned,non-aligned
31,study7Line,12.0,33,30,2513,31,stackbar,set4,-1,1,False,0.16992500144231237,6,0,start0,aligned
31,study7Line,9.0,34,45,2514,42,stackbar,set2,3,3,False,1.6438561897747246,8,0,start0,aligned
31,study7Line,6.0,35,49,2515,49,stackbar,set4,0,0,True,-3.0,1,0,start0,aligned
31,study7Line,15.0,36,25,2516,26,stackbar,set2,-1,1,False,0.16992500144231237,1,10,non-aligned,non-aligned
31,study7Line,17.0,37,40,2517,40,stackbar,set4,0,0,True,-3.0,10,2,non-aligned,non-aligned
31,study7Line,34.0,38,50,2518,43,stackbar,set2,7,7,False,2.8328900141647417,7,2,non-aligned,non-aligned
31,study7Line,9.0,39,60,2519,48,stackbar,set1,12,12,False,3.599912842187128,2,9,non-aligned,non-aligned
31,study7Line,10.0,40,30,2520,28,stackbar,set4,2,2,False,1.0874628412503393,3,0,start0,aligned
31,study7Line,16.0,41,45,2521,47,stackbar,set1,-2,2,False,1.0874628412503393,3,2,non-aligned,non-aligned
31,study7Line,21.0,42,20,2522,16,stackbar,set2,4,4,False,2.0443941193584534,9,2,non-aligned,non-aligned
31,study7Line,10.0,43,40,2523,39,stackbar,set3,1,1,False,0.16992500144231237,11,0,start0,aligned
31,study7Line,10.0,44,22,2524,22,stackbar,set1,0,0,True,-3.0,3,0,start0,aligned
31,study7Line,10.0,45,35,2525,35,stackbar,set4,0,0,True,-3.0,10,0,start0,aligned
31,study7Line,12.0,46,20,2526,21,stackbar,set1,-1,1,False,0.16992500144231237,4,1,non-aligned,non-aligned
31,study7Line,8.0,47,48,2527,47,stackbar,set2,1,1,False,0.16992500144231237,3,0,start0,aligned
31,study7Line,8.0,48,25,2528,24,stackbar,set3,1,1,False,0.16992500144231237,1,8,non-aligned,non-aligned
31,study7Line,9.0,49,22,2529,22,stackbar,set4,0,0,True,-3.0,3,0,start75,aligned
31,study7Line,10.0,50,35,2530,30,stackbar,set1,5,5,False,2.357552004618084,5,8,non-aligned,non-aligned
31,study7Line,12.0,51,15,2531,13,stackbar,set1,2,2,False,1.0874628412503393,12,6,non-aligned,non-aligned
31,study7Line,12.0,52,15,2532,18,stackbar,set3,-3,3,False,1.6438561897747246,7,2,non-aligned,non-aligned
31,study7Line,7.0,53,15,2533,19,stackbar,set2,-4,4,False,2.0443941193584534,6,2,non-aligned,non-aligned
31,study7Line,9.0,54,45,2534,41,stackbar,set1,4,4,False,2.0443941193584534,9,0,start0,aligned
31,study7Line,8.0,55,50,2535,41,stackbar,set1,9,9,False,3.189824558880017,9,6,non-aligned,non-aligned
31,study7Line,8.0,56,30,2536,29,stackbar,set4,1,1,False,0.16992500144231237,4,0,start0,aligned
31,study7Line,7.0,57,50,2537,50,stackbar,set3,0,0,True,-3.0,0,0,start0,aligned
31,study7Line,13.0,58,48,2538,48,stackbar,set4,0,0,True,-3.0,2,0,start0,aligned
31,study7Line,17.0,59,30,2539,39,stackbar,set1,-9,9,False,3.189824558880017,11,4,non-aligned,non-aligned
31,study7Line,14.0,60,40,2540,42,stackbar,set3,-2,2,False,1.0874628412503393,8,7,non-aligned,non-aligned
31,study7Line,15.0,61,35,2541,35,stackbar,set4,0,0,True,-3.0,10,0,end100,aligned
31,study7Line,8.0,62,25,2542,23,stackbar,set1,2,2,False,1.0874628412503393,2,3,non-aligned,non-aligned
31,study7Line,9.0,63,15,2543,12,stackbar,set1,3,3,False,1.6438561897747246,12,0,start0,aligned
31,study7Line,7.0,64,40,2544,38,stackbar,set1,2,2,False,1.0874628412503393,12,0,start0,aligned
31,study7Line,12.0,65,24,2545,24,stackbar,set1,0,0,True,-3.0,1,0,start0,aligned
31,study7Line,8.0,66,30,2546,32,stackbar,set2,-2,2,False,1.0874628412503393,7,0,start0,aligned
31,study7Line,8.0,67,40,2547,32,stackbar,set2,8,8,False,3.0223678130284544,7,6,non-aligned,non-aligned
31,study7Line,6.0,68,30,2548,29,stackbar,set4,1,1,False,0.16992500144231237,4,3,non-aligned,non-aligned
31,study7Line,7.0,69,45,2549,45,stackbar,set3,0,0,True,-3.0,5,0,start0,aligned
31,study7Line,18.0,70,15,2550,16,stackbar,set1,-1,1,False,0.16992500144231237,9,0,start0,aligned
31,study7Line,6.0,71,40,2551,40,stackbar,set3,0,0,True,-3.0,10,0,start0,aligned
31,study7Line,8.0,72,25,2552,25,stackbar,set3,0,0,True,-3.0,0,5,non-aligned,non-aligned
31,study7Line,8.0,73,20,2553,18,stackbar,set1,2,2,False,1.0874628412503393,7,0,start0,aligned
31,study7Line,7.0,74,45,2554,43,stackbar,set1,2,2,False,1.0874628412503393,7,0,start0,aligned
31,study7Line,10.0,75,25,2555,28,stackbar,set3,-3,3,False,1.6438561897747246,3,9,non-aligned,non-aligned
31,study7Line,9.0,76,35,2556,37,stackbar,set1,-2,2,False,1.0874628412503393,12,6,non-aligned,non-aligned
31,study7Line,8.0,77,35,2557,34,stackbar,set3,1,1,False,0.16992500144231237,9,0,start0,aligned
31,study7Line,5.0,78,30,2558,30,stackbar,set2,0,0,True,-3.0,5,0,start0,aligned
31,study7Line,7.0,79,25,2559,25,stackbar,set1,0,0,True,-3.0,0,0,start0,aligned
2,study7Line,9.0,0,35,160,36,stackbar,set3,-1,1,False,0.16992500144231237,11,3,non-aligned,non-aligned
2,study7Line,6.0,1,30,161,29,stackbar,set4,1,1,False,0.16992500144231237,4,0,start0,aligned
2,study7Line,4.0,2,20,162,20,stackbar,set1,0,0,True,-3.0,5,0,start0,aligned
2,study7Line,5.0,3,45,163,47,stackbar,set1,-2,2,False,1.0874628412503393,3,0,start0,aligned
2,study7Line,6.0,4,25,164,25,stackbar,set1,0,0,True,-3.0,0,7,non-aligned,non-aligned
2,study7Line,14.0,5,15,165,17,stackbar,set3,-2,2,False,1.0874628412503393,8,3,non-aligned,non-aligned
2,study7Line,6.0,6,20,166,22,stackbar,set4,-2,2,False,1.0874628412503393,3,0,start75,aligned
2,study7Line,4.0,7,20,167,22,stackbar,set1,-2,2,False,1.0874628412503393,3,0,start0,aligned
2,study7Line,6.0,8,45,168,49,stackbar,set3,-4,4,False,2.0443941193584534,1,0,start0,aligned
2,study7Line,6.0,9,25,169,26,stackbar,set2,-1,1,False,0.16992500144231237,1,10,non-aligned,non-aligned
2,study7Line,7.0,10,45,170,45,stackbar,set1,0,0,True,-3.0,5,0,start0,aligned
2,study7Line,7.0,11,35,171,34,stackbar,set3,1,1,False,0.16992500144231237,9,3,non-aligned,non-aligned
2,study7Line,8.0,12,35,172,35,stackbar,set2,0,0,True,-3.0,10,0,start0,aligned
2,study7Line,5.0,13,30,173,27,stackbar,set4,3,3,False,1.6438561897747246,2,0,start0,aligned
2,study7Line,4.0,14,30,174,30,stackbar,set3,0,0,True,-3.0,5,0,start0,aligned
2,study7Line,7.0,15,40,175,39,stackbar,set2,1,1,False,0.16992500144231237,11,0,start0,aligned
2,study7Line,11.0,16,45,176,42,stackbar,set4,3,3,False,1.6438561897747246,8,1,non-aligned,non-aligned
2,study7Line,4.0,17,15,177,16,stackbar,set3,-1,1,False,0.16992500144231237,9,0,start0,aligned
2,study7Line,5.0,18,40,178,42,stackbar,set3,-2,2,False,1.0874628412503393,8,0,start0,aligned
2,study7Line,8.0,19,40,179,45,stackbar,set3,-5,5,False,2.357552004618084,5,7,non-aligned,non-aligned
2,study7Line,6.0,20,50,180,50,stackbar,set1,0,0,True,-3.0,0,6,non-aligned,non-aligned
2,study7Line,8.0,21,40,181,41,stackbar,set3,-1,1,False,0.16992500144231237,9,1,non-aligned,non-aligned
2,study7Line,7.0,22,35,182,39,stackbar,set1,-4,4,False,2.0443941193584534,11,4,non-aligned,non-aligned
2,study7Line,6.0,23,30,183,30,stackbar,set1,0,0,True,-3.0,5,8,non-aligned,non-aligned
2,study7Line,7.0,24,10,184,13,stackbar,set4,-3,3,False,1.6438561897747246,12,0,start0,aligned
2,study7Line,4.0,25,20,185,21,stackbar,set4,-1,1,False,0.16992500144231237,4,0,start0,aligned
2,study7Line,10.0,26,40,186,44,stackbar,set3,-4,4,False,2.0443941193584534,6,8,non-aligned,non-aligned
2,study7Line,5.0,27,35,187,33,stackbar,set4,2,2,False,1.0874628412503393,8,0,start0,aligned
2,study7Line,4.0,28,40,188,43,stackbar,set2,-3,3,False,1.6438561897747246,7,0,start0,aligned
2,study7Line,5.0,29,15,189,14,stackbar,set4,1,1,False,0.16992500144231237,11,0,start0,aligned
2,study7Line,4.0,30,40,190,41,stackbar,set2,-1,1,False,0.16992500144231237,9,0,start0,aligned
2,study7Line,4.0,31,30,191,32,stackbar,set1,-2,2,False,1.0874628412503393,7,0,start0,aligned
2,study7Line,4.0,32,30,192,34,stackbar,set2,-4,4,False,2.0443941193584534,9,0,start0,aligned
2,study7Line,8.0,33,45,193,46,stackbar,set3,-1,1,False,0.16992500144231237,4,10,non-aligned,non-aligned
2,study7Line,5.0,34,10,194,12,stackbar,set3,-2,2,False,1.0874628412503393,12,0,start0,aligned
2,study7Line,5.0,35,10,195,12,stackbar,set2,-2,2,False,1.0874628412503393,12,1,non-aligned,non-aligned
2,study7Line,4.0,36,20,196,19,stackbar,set2,1,1,False,0.16992500144231237,6,0,start0,aligned
2,study7Line,5.0,37,50,197,48,stackbar,set4,2,2,False,1.0874628412503393,2,2,non-aligned,non-aligned
2,study7Line,4.0,38,15,198,19,stackbar,set1,-4,4,False,2.0443941193584534,6,8,non-aligned,non-aligned
2,study7Line,5.0,39,50,199,47,stackbar,set2,3,3,False,1.6438561897747246,3,2,non-aligned,non-aligned
2,study7Line,3.0,40,45,200,46,stackbar,set1,-1,1,False,0.16992500144231237,4,0,start0,aligned
2,study7Line,5.0,41,10,201,11,stackbar,set2,-1,1,False,0.16992500144231237,11,2,non-aligned,non-aligned
2,study7Line,6.0,42,40,202,38,stackbar,set3,2,2,False,1.0874628412503393,12,3,non-aligned,non-aligned
2,study7Line,5.0,43,30,203,31,stackbar,set3,-1,1,False,0.16992500144231237,6,0,start0,aligned
2,study7Line,4.0,44,30,204,28,stackbar,set2,2,2,False,1.0874628412503393,3,0,start0,aligned
2,study7Line,4.0,45,40,205,44,stackbar,set3,-4,4,False,2.0443941193584534,6,0,start0,aligned
2,study7Line,5.0,46,25,206,24,stackbar,set2,1,1,False,0.16992500144231237,1,2,non-aligned,non-aligned
2,study7Line,4.0,47,10,207,13,stackbar,set2,-3,3,False,1.6438561897747246,12,6,non-aligned,non-aligned
2,study7Line,5.0,48,50,208,43,stackbar,set1,7,7,False,2.8328900141647417,7,2,non-aligned,non-aligned
2,study7Line,4.0,49,15,209,15,stackbar,set4,0,0,True,-3.0,10,0,start0,aligned
2,study7Line,3.0,50,15,210,14,stackbar,set1,1,1,False,0.16992500144231237,11,5,non-aligned,non-aligned
2,study7Line,4.0,51,20,211,21,stackbar,set1,-1,1,False,0.16992500144231237,4,1,non-aligned,non-aligned
2,study7Line,9.0,52,40,212,40,stackbar,set3,0,0,True,-3.0,10,0,start0,aligned
2,study7Line,5.0,53,25,213,28,stackbar,set4,-3,3,False,1.6438561897747246,3,5,non-aligned,non-aligned
2,study7Line,4.0,54,25,214,25,stackbar,set1,0,0,True,-3.0,0,0,start0,aligned
2,study7Line,5.0,55,20,215,20,stackbar,set2,0,0,True,-3.0,5,0,start75,aligned
2,study7Line,3.0,56,50,216,50,stackbar,set1,0,0,True,-3.0,0,0,start0,aligned
2,study7Line,3.0,57,20,217,18,stackbar,set4,2,2,False,1.0874628412503393,7,0,start0,aligned
2,study7Line,6.0,58,30,218,32,stackbar,set4,-2,2,False,1.0874628412503393,7,7,non-aligned,non-aligned
2,study7Line,5.0,59,35,219,35,stackbar,set4,0,0,True,-3.0,10,0,end100,aligned
2,study7Line,5.0,60,20,220,23,stackbar,set4,-3,3,False,1.6438561897747246,2,10,non-aligned,non-aligned
2,study7Line,5.0,61,35,221,37,stackbar,set3,-2,2,False,1.0874628412503393,12,0,start25,aligned
2,study7Line,4.0,62,25,222,26,stackbar,set3,-1,1,False,0.16992500144231237,1,0,start0,aligned
2,study7Line,4.0,63,35,223,36,stackbar,set3,-1,1,False,0.16992500144231237,11,0,start0,aligned
2,study7Line,4.0,64,30,224,29,stackbar,set4,1,1,False,0.16992500144231237,4,3,non-aligned,non-aligned
2,study7Line,4.0,65,20,225,23,stackbar,set1,-3,3,False,1.6438561897747246,2,0,start0,aligned
2,study7Line,4.0,66,35,226,37,stackbar,set4,-2,2,False,1.0874628412503393,12,0,start0,aligned
2,study7Line,5.0,67,35,227,33,stackbar,set1,2,2,False,1.0874628412503393,8,6,non-aligned,non-aligned
2,study7Line,3.0,68,15,228,17,stackbar,set3,-2,2,False,1.0874628412503393,8,0,start0,aligned
2,study7Line,4.0,69,25,229,27,stackbar,set1,-2,2,False,1.0874628412503393,2,2,non-aligned,non-aligned
2,study7Line,6.0,70,30,230,31,stackbar,set1,-1,1,False,0.16992500144231237,6,4,non-aligned,non-aligned
2,study7Line,6.0,71,40,231,40,stackbar,set2,0,0,True,-3.0,10,1,non-aligned,non-aligned
2,study7Line,4.0,72,10,232,15,stackbar,set2,-5,5,False,2.357552004618084,10,4,non-aligned,non-aligned
2,study7Line,4.0,73,50,233,49,stackbar,set3,1,1,False,0.16992500144231237,1,1,non-aligned,non-aligned
2,study7Line,5.0,74,35,234,38,stackbar,set2,-3,3,False,1.6438561897747246,12,0,start0,aligned
2,study7Line,5.0,75,15,235,16,stackbar,set2,-1,1,False,0.16992500144231237,9,2,non-aligned,non-aligned
2,study7Line,4.0,76,45,236,48,stackbar,set4,-3,3,False,1.6438561897747246,2,0,start0,aligned
2,study7Line,3.0,77,25,237,24,stackbar,set2,1,1,False,0.16992500144231237,1,0,start0,aligned
2,study7Line,4.0,78,20,238,18,stackbar,set3,2,2,False,1.0874628412503393,7,2,non-aligned,non-aligned
2,study7Line,4.0,79,10,239,11,stackbar,set1,-1,1,False,0.16992500144231237,11,0,start0,aligned
16,study7Line,12.0,0,50,1280,43,stackbar,set4,7,7,False,2.8328900141647417,7,6,non-aligned,non-aligned
16,study7Line,12.0,1,18,1281,18,stackbar,set1,0,0,True,-3.0,7,1,non-aligned,non-aligned
16,study7Line,10.0,2,15,1282,17,stackbar,set1,-2,2,False,1.0874628412503393,8,0,start0,aligned
16,study7Line,10.0,3,40,1283,39,stackbar,set4,1,1,False,0.16992500144231237,11,0,start0,aligned
16,study7Line,9.0,4,30,1284,33,stackbar,set1,-3,3,False,1.6438561897747246,8,0,start0,aligned
16,study7Line,13.0,5,35,1285,37,stackbar,set1,-2,2,False,1.0874628412503393,12,6,non-aligned,non-aligned
16,study7Line,7.0,6,20,1286,19,stackbar,set2,1,1,False,0.16992500144231237,6,0,start0,aligned
16,study7Line,8.0,7,34,1287,35,stackbar,set2,-1,1,False,0.16992500144231237,10,0,start0,aligned
16,study7Line,8.0,8,47,1288,46,stackbar,set1,1,1,False,0.16992500144231237,4,0,start0,aligned
16,study7Line,10.0,9,45,1289,44,stackbar,set4,1,1,False,0.16992500144231237,6,2,non-aligned,non-aligned
16,study7Line,10.0,10,28,1290,30,stackbar,set1,-2,2,False,1.0874628412503393,5,0,start0,aligned
16,study7Line,11.0,11,18,1291,16,stackbar,set3,2,2,False,1.0874628412503393,9,3,non-aligned,non-aligned
16,study7Line,9.0,12,50,1292,47,stackbar,set4,3,3,False,1.6438561897747246,3,10,non-aligned,non-aligned
16,study7Line,9.0,13,30,1293,33,stackbar,set1,-3,3,False,1.6438561897747246,8,6,non-aligned,non-aligned
16,study7Line,15.0,14,45,1294,41,stackbar,set2,4,4,False,2.0443941193584534,9,4,non-aligned,non-aligned
16,study7Line,13.0,15,30,1295,30,stackbar,set4,0,0,True,-3.0,5,1,non-aligned,non-aligned
16,study7Line,8.0,16,45,1296,45,stackbar,set1,0,0,True,-3.0,5,0,start0,aligned
16,study7Line,13.0,17,40,1297,40,stackbar,set3,0,0,True,-3.0,10,2,non-aligned,non-aligned
16,study7Line,10.0,18,45,1298,44,stackbar,set3,1,1,False,0.16992500144231237,6,0,start0,aligned
16,study7Line,9.0,19,10,1299,17,stackbar,set4,-7,7,False,2.8328900141647417,8,1,non-aligned,non-aligned
16,study7Line,8.0,20,48,1300,48,stackbar,set1,0,0,True,-3.0,2,0,start0,aligned
16,study7Line,12.0,21,30,1301,35,stackbar,set1,-5,5,False,2.357552004618084,10,6,non-aligned,non-aligned
16,study7Line,8.0,22,47,1302,47,stackbar,set4,0,0,True,-3.0,3,0,start0,aligned
16,study7Line,5.0,23,50,1303,50,stackbar,set4,0,0,True,-3.0,0,0,start0,aligned
16,study7Line,7.0,24,10,1304,12,stackbar,set1,-2,2,False,1.0874628412503393,12,0,start0,aligned
16,study7Line,10.0,25,30,1305,32,stackbar,set3,-2,2,False,1.0874628412503393,7,2,non-aligned,non-aligned
16,study7Line,7.0,26,15,1306,15,stackbar,set3,0,0,True,-3.0,10,0,start0,aligned
16,study7Line,7.0,27,35,1307,36,stackbar,set3,-1,1,False,0.16992500144231237,11,3,non-aligned,non-aligned
16,study7Line,8.0,28,22,1308,21,stackbar,set3,1,1,False,0.16992500144231237,4,2,non-aligned,non-aligned
16,study7Line,9.0,29,45,1309,42,stackbar,set3,3,3,False,1.6438561897747246,8,7,non-aligned,non-aligned
16,study7Line,11.0,30,15,1310,15,stackbar,set4,0,0,True,-3.0,10,4,non-aligned,non-aligned
16,study7Line,5.0,31,26,1311,26,stackbar,set3,0,0,True,-3.0,1,0,start0,aligned
16,study7Line,8.0,32,55,1312,50,stackbar,set1,5,5,False,2.357552004618084,0,6,non-aligned,non-aligned
16,study7Line,10.0,33,40,1313,46,stackbar,set4,-6,6,False,2.6147098441152083,4,2,non-aligned,non-aligned
16,study7Line,10.0,34,27,1314,27,stackbar,set2,0,0,True,-3.0,2,0,start0,aligned
16,study7Line,6.0,35,30,1315,31,stackbar,set3,-1,1,False,0.16992500144231237,6,0,start0,aligned
16,study7Line,6.0,36,25,1316,24,stackbar,set2,1,1,False,0.16992500144231237,1,2,non-aligned,non-aligned
16,study7Line,7.0,37,28,1317,29,stackbar,set1,-1,1,False,0.16992500144231237,4,0,start0,aligned
16,study7Line,11.0,38,40,1318,41,stackbar,set1,-1,1,False,0.16992500144231237,9,0,start0,aligned
16,study7Line,12.0,39,25,1319,23,stackbar,set3,2,2,False,1.0874628412503393,2,10,non-aligned,non-aligned
16,study7Line,7.0,40,30,1320,28,stackbar,set4,2,2,False,1.0874628412503393,3,5,non-aligned,non-aligned
16,study7Line,7.0,41,30,1321,34,stackbar,set4,-4,4,False,2.0443941193584534,9,2,non-aligned,non-aligned
16,study7Line,8.0,42,25,1322,25,stackbar,set2,0,0,True,-3.0,0,8,non-aligned,non-aligned
16,study7Line,8.0,43,10,1323,11,stackbar,set2,-1,1,False,0.16992500144231237,11,2,non-aligned,non-aligned
16,study7Line,7.0,44,30,1324,32,stackbar,set2,-2,2,False,1.0874628412503393,7,0,start0,aligned
16,study7Line,14.0,45,38,1325,40,stackbar,set4,-2,2,False,1.0874628412503393,10,0,start0,aligned
16,study7Line,6.0,46,23,1326,23,stackbar,set4,0,0,True,-3.0,2,0,start0,aligned
16,study7Line,7.0,47,15,1327,20,stackbar,set2,-5,5,False,2.357552004618084,5,0,start75,aligned
16,study7Line,6.0,48,22,1328,22,stackbar,set4,0,0,True,-3.0,3,0,start0,aligned
16,study7Line,8.0,49,23,1329,22,stackbar,set2,1,1,False,0.16992500144231237,3,9,non-aligned,non-aligned
16,study7Line,5.0,50,45,1330,42,stackbar,set2,3,3,False,1.6438561897747246,8,0,start0,aligned
16,study7Line,5.0,51,24,1331,24,stackbar,set2,0,0,True,-3.0,1,0,start0,aligned
16,study7Line,6.0,52,14,1332,14,stackbar,set4,0,0,True,-3.0,11,6,non-aligned,non-aligned
16,study7Line,10.0,53,38,1333,36,stackbar,set1,2,2,False,1.0874628412503393,11,0,start0,aligned
16,study7Line,9.0,54,35,1334,37,stackbar,set2,-2,2,False,1.0874628412503393,12,0,start0,aligned
16,study7Line,5.0,55,15,1335,16,stackbar,set3,-1,1,False,0.16992500144231237,9,0,start0,aligned
16,study7Line,6.0,56,49,1336,49,stackbar,set2,0,0,True,-3.0,1,0,start0,aligned
16,study7Line,10.0,57,45,1337,43,stackbar,set2,2,2,False,1.0874628412503393,7,0,start0,aligned
16,study7Line,6.0,58,13,1338,14,stackbar,set1,-1,1,False,0.16992500144231237,11,0,start0,aligned
16,study7Line,6.0,59,40,1339,38,stackbar,set3,2,2,False,1.0874628412503393,12,0,start0,aligned
16,study7Line,9.0,60,45,1340,39,stackbar,set2,6,6,False,2.6147098441152083,11,1,non-aligned,non-aligned
16,study7Line,7.0,61,18,1341,18,stackbar,set1,0,0,True,-3.0,7,0,start0,aligned
16,study7Line,6.0,62,50,1342,48,stackbar,set3,2,2,False,1.0874628412503393,2,2,non-aligned,non-aligned
16,study7Line,7.0,63,48,1343,49,stackbar,set4,-1,1,False,0.16992500144231237,1,5,non-aligned,non-aligned
16,study7Line,9.0,64,33,1344,31,stackbar,set1,2,2,False,1.0874628412503393,6,4,non-aligned,non-aligned
16,study7Line,8.0,65,10,1345,11,stackbar,set2,-1,1,False,0.16992500144231237,11,0,start0,aligned
16,study7Line,6.0,66,25,1346,25,stackbar,set4,0,0,True,-3.0,0,0,start0,aligned
16,study7Line,6.0,67,15,1347,13,stackbar,set2,2,2,False,1.0874628412503393,12,6,non-aligned,non-aligned
16,study7Line,7.0,68,18,1348,20,stackbar,set2,-2,2,False,1.0874628412503393,5,0,start0,aligned
16,study7Line,7.0,69,45,1349,45,stackbar,set1,0,0,True,-3.0,5,2,non-aligned,non-aligned
16,study7Line,7.0,70,28,1350,29,stackbar,set2,-1,1,False,0.16992500144231237,4,2,non-aligned,non-aligned
16,study7Line,6.0,71,10,1351,12,stackbar,set2,-2,2,False,1.0874628412503393,12,1,non-aligned,non-aligned
16,study7Line,7.0,72,23,1352,21,stackbar,set4,2,2,False,1.0874628412503393,4,0,start0,aligned
16,study7Line,7.0,73,40,1353,38,stackbar,set3,2,2,False,1.0874628412503393,12,3,non-aligned,non-aligned
16,study7Line,7.0,74,26,1354,26,stackbar,set4,0,0,True,-3.0,1,1,non-aligned,non-aligned
16,study7Line,7.0,75,13,1355,13,stackbar,set1,0,0,True,-3.0,12,0,start0,aligned
16,study7Line,7.0,76,18,1356,19,stackbar,set2,-1,1,False,0.16992500144231237,6,2,non-aligned,non-aligned
16,study7Line,6.0,77,28,1357,28,stackbar,set4,0,0,True,-3.0,3,0,start0,aligned
16,study7Line,6.0,78,35,1358,34,stackbar,set4,1,1,False,0.16992500144231237,9,0,start0,aligned
16,study7Line,6.0,79,28,1359,27,stackbar,set1,1,1,False,0.16992500144231237,2,2,non-aligned,non-aligned
38,study7Line,42.0,0,20,3040,17,stackbar,set2,3,3,False,1.6438561897747246,8,5,non-aligned,non-aligned
38,study7Line,28.0,1,40,3041,39,stackbar,set1,1,1,False,0.16992500144231237,11,4,non-aligned,non-aligned
38,study7Line,17.0,2,25,3042,29,stackbar,set2,-4,4,False,2.0443941193584534,4,2,non-aligned,non-aligned
38,study7Line,44.0,3,40,3043,42,stackbar,set2,-2,2,False,1.0874628412503393,8,0,start0,aligned
38,study7Line,11.0,4,50,3044,50,stackbar,set4,0,0,True,-3.0,0,0,start0,aligned
38,study7Line,41.0,5,12,3045,15,stackbar,set4,-3,3,False,1.6438561897747246,10,0,start0,aligned
38,study7Line,14.0,6,30,3046,34,stackbar,set1,-4,4,False,2.0443941193584534,9,6,non-aligned,non-aligned
38,study7Line,13.0,7,45,3047,42,stackbar,set3,3,3,False,1.6438561897747246,8,7,non-aligned,non-aligned
38,study7Line,13.0,8,25,3048,25,stackbar,set2,0,0,True,-3.0,0,8,non-aligned,non-aligned
38,study7Line,25.0,9,20,3049,15,stackbar,set2,5,5,False,2.357552004618084,10,4,non-aligned,non-aligned
38,study7Line,15.0,10,15,3050,13,stackbar,set3,2,2,False,1.0874628412503393,12,2,non-aligned,non-aligned
38,study7Line,12.0,11,30,3051,30,stackbar,set4,0,0,True,-3.0,5,1,non-aligned,non-aligned
38,study7Line,462.0,12,45,3052,45,stackbar,set3,0,0,True,-3.0,5,0,start0,aligned
38,study7Line,23.0,13,12,3053,14,stackbar,set4,-2,2,False,1.0874628412503393,11,6,non-aligned,non-aligned
38,study7Line,18.0,14,30,3054,35,stackbar,set3,-5,5,False,2.357552004618084,10,0,start0,aligned
38,study7Line,52.0,15,30,3055,30,stackbar,set3,0,0,True,-3.0,5,0,start0,aligned
38,study7Line,25.0,16,17,3056,18,stackbar,set2,-1,1,False,0.16992500144231237,7,0,start0,aligned
38,study7Line,22.0,17,30,3057,19,stackbar,set2,11,11,False,3.4757334309663976,6,0,start0,aligned
38,study7Line,35.0,18,35,3058,33,stackbar,set3,2,2,False,1.0874628412503393,8,3,non-aligned,non-aligned
38,study7Line,15.0,19,25,3059,31,stackbar,set1,-6,6,False,2.6147098441152083,6,4,non-aligned,non-aligned
38,study7Line,79.0,20,45,3060,44,stackbar,set1,1,1,False,0.16992500144231237,6,0,start0,aligned
38,study7Line,473.0,21,30,3061,22,stackbar,set3,8,8,False,3.0223678130284544,3,2,non-aligned,non-aligned
38,study7Line,12.0,22,30,3062,29,stackbar,set3,1,1,False,0.16992500144231237,4,0,start0,aligned
38,study7Line,13.0,23,12,3063,16,stackbar,set3,-4,4,False,2.0443941193584534,9,0,start0,aligned
38,study7Line,10.0,24,25,3064,23,stackbar,set3,2,2,False,1.0874628412503393,2,10,non-aligned,non-aligned
38,study7Line,14.0,25,20,3065,16,stackbar,set1,4,4,False,2.0443941193584534,9,1,non-aligned,non-aligned
38,study7Line,8.0,26,25,3066,28,stackbar,set2,-3,3,False,1.6438561897747246,3,8,non-aligned,non-aligned
38,study7Line,16.0,27,40,3067,43,stackbar,set2,-3,3,False,1.6438561897747246,7,0,start0,aligned
38,study7Line,7.0,28,10,3068,14,stackbar,set2,-4,4,False,2.0443941193584534,11,0,start0,aligned
38,study7Line,11.0,29,12,3069,11,stackbar,set3,1,1,False,0.16992500144231237,11,5,non-aligned,non-aligned
38,study7Line,67.0,30,37,3070,37,stackbar,set3,0,0,True,-3.0,12,0,start0,aligned
38,study7Line,12.0,31,37,3071,38,stackbar,set1,-1,1,False,0.16992500144231237,12,1,non-aligned,non-aligned
38,study7Line,17.0,32,47,3072,48,stackbar,set1,-1,1,False,0.16992500144231237,2,0,start0,aligned
38,study7Line,12.0,33,40,3073,45,stackbar,set3,-5,5,False,2.357552004618084,5,7,non-aligned,non-aligned
38,study7Line,7.0,34,37,3074,39,stackbar,set1,-2,2,False,1.0874628412503393,11,0,start0,aligned
38,study7Line,11.0,35,40,3075,41,stackbar,set1,-1,1,False,0.16992500144231237,9,6,non-aligned,non-aligned
38,study7Line,17.0,36,50,3076,50,stackbar,set2,0,0,True,-3.0,0,4,non-aligned,non-aligned
38,study7Line,10.0,37,48,3077,49,stackbar,set2,-1,1,False,0.16992500144231237,1,0,start0,aligned
38,study7Line,11.0,38,45,3078,44,stackbar,set3,1,1,False,0.16992500144231237,6,8,non-aligned,non-aligned
38,study7Line,9.0,39,40,3079,41,stackbar,set1,-1,1,False,0.16992500144231237,9,0,start0,aligned
38,study7Line,12.0,40,20,3080,21,stackbar,set4,-1,1,False,0.16992500144231237,4,2,non-aligned,non-aligned
38,study7Line,43.0,41,50,3081,46,stackbar,set3,4,4,False,2.0443941193584534,4,10,non-aligned,non-aligned
38,study7Line,29.0,42,25,3082,27,stackbar,set1,-2,2,False,1.0874628412503393,2,2,non-aligned,non-aligned
38,study7Line,64.0,43,45,3083,43,stackbar,set1,2,2,False,1.0874628412503393,7,2,non-aligned,non-aligned
38,study7Line,38.0,44,10,3084,12,stackbar,set3,-2,2,False,1.0874628412503393,12,0,start0,aligned
38,study7Line,9.0,45,50,3085,49,stackbar,set2,1,1,False,0.16992500144231237,1,8,non-aligned,non-aligned
38,study7Line,9.0,46,15,3086,18,stackbar,set1,-3,3,False,1.6438561897747246,7,1,non-aligned,non-aligned
38,study7Line,10.0,47,22,3087,24,stackbar,set3,-2,2,False,1.0874628412503393,1,0,start0,aligned
38,study7Line,7.0,48,27,3088,26,stackbar,set4,1,1,False,0.16992500144231237,1,0,start0,aligned
38,study7Line,44.0,49,48,3089,47,stackbar,set1,1,1,False,0.16992500144231237,3,2,non-aligned,non-aligned
38,study7Line,16.0,50,30,3090,36,stackbar,set4,-6,6,False,2.6147098441152083,11,3,non-aligned,non-aligned
38,study7Line,10.0,51,35,3091,33,stackbar,set4,2,2,False,1.0874628412503393,8,0,start0,aligned
38,study7Line,10.0,52,46,3092,47,stackbar,set3,-1,1,False,0.16992500144231237,3,0,start0,aligned
38,study7Line,9.0,53,30,3093,31,stackbar,set3,-1,1,False,0.16992500144231237,6,0,start0,aligned
38,study7Line,9.0,54,12,3094,12,stackbar,set3,0,0,True,-3.0,12,1,non-aligned,non-aligned
38,study7Line,9.0,55,37,3095,36,stackbar,set1,1,1,False,0.16992500144231237,11,0,start0,aligned
38,study7Line,11.0,56,37,3096,40,stackbar,set2,-3,3,False,1.6438561897747246,10,1,non-aligned,non-aligned
38,study7Line,5.0,57,10,3097,13,stackbar,set1,-3,3,False,1.6438561897747246,12,0,start0,aligned
38,study7Line,9.0,58,32,3098,34,stackbar,set4,-2,2,False,1.0874628412503393,9,0,start0,aligned
38,study7Line,11.0,59,37,3099,37,stackbar,set3,0,0,True,-3.0,12,0,start25,aligned
38,study7Line,7.0,60,20,3100,21,stackbar,set2,-1,1,False,0.16992500144231237,4,0,start0,aligned
38,study7Line,8.0,61,15,3101,17,stackbar,set2,-2,2,False,1.0874628412503393,8,0,start0,aligned
38,study7Line,9.0,62,25,3102,24,stackbar,set3,1,1,False,0.16992500144231237,1,8,non-aligned,non-aligned
38,study7Line,10.0,63,40,3103,38,stackbar,set3,2,2,False,1.0874628412503393,12,0,start0,aligned
38,study7Line,5.0,64,10,3104,11,stackbar,set1,-1,1,False,0.16992500144231237,11,0,start0,aligned
38,study7Line,6.0,65,45,3105,46,stackbar,set2,-1,1,False,0.16992500144231237,4,0,start0,aligned
38,study7Line,40.0,66,28,3106,28,stackbar,set1,0,0,True,-3.0,3,0,start0,aligned
38,study7Line,30.0,67,20,3107,20,stackbar,set2,0,0,True,-3.0,5,0,start0,aligned
38,study7Line,29.0,68,37,3108,35,stackbar,set3,2,2,False,1.0874628412503393,10,2,non-aligned,non-aligned
38,study7Line,16.0,69,25,3109,25,stackbar,set4,0,0,True,-3.0,0,0,start0,aligned
38,study7Line,18.0,70,40,3110,40,stackbar,set4,0,0,True,-3.0,10,0,start0,aligned
38,study7Line,13.0,71,37,3111,32,stackbar,set3,5,5,False,2.357552004618084,7,2,non-aligned,non-aligned
38,study7Line,12.0,72,30,3112,22,stackbar,set1,8,8,False,3.0223678130284544,3,0,start0,aligned
38,study7Line,21.0,73,30,3113,19,stackbar,set3,11,11,False,3.4757334309663976,6,1,non-aligned,non-aligned
38,study7Line,37.0,74,27,3114,27,stackbar,set1,0,0,True,-3.0,2,0,start0,aligned
38,study7Line,17.0,75,47,3115,48,stackbar,set3,-1,1,False,0.16992500144231237,2,2,non-aligned,non-aligned
38,study7Line,30.0,76,25,3116,26,stackbar,set2,-1,1,False,0.16992500144231237,1,10,non-aligned,non-aligned
38,study7Line,13.0,77,20,3117,20,stackbar,set4,0,0,True,-3.0,5,5,non-aligned,non-aligned
38,study7Line,12.0,78,21,3118,23,stackbar,set1,-2,2,False,1.0874628412503393,2,0,start0,aligned
38,study7Line,10.0,79,37,3119,32,stackbar,set2,5,5,False,2.357552004618084,7,0,start0,aligned
24,study7Line,8.0,0,25,1920,25,stackbar,set1,0,0,True,-3.0,0,0,start0,aligned
24,study7Line,8.0,1,29,1921,29,stackbar,set1,0,0,True,-3.0,4,2,non-aligned,non-aligned
24,study7Line,21.0,2,40,1922,35,stackbar,set1,5,5,False,2.357552004618084,10,6,non-aligned,non-aligned
24,study7Line,10.0,3,30,1923,31,stackbar,set2,-1,1,False,0.16992500144231237,6,1,non-aligned,non-aligned
24,study7Line,12.0,4,24,1924,22,stackbar,set2,2,2,False,1.0874628412503393,3,9,non-aligned,non-aligned
24,study7Line,11.0,5,43,1925,41,stackbar,set3,2,2,False,1.0874628412503393,9,1,non-aligned,non-aligned
24,study7Line,10.0,6,27,1926,25,stackbar,set2,2,2,False,1.0874628412503393,0,8,non-aligned,non-aligned
24,study7Line,9.0,7,30,1927,34,stackbar,set3,-4,4,False,2.0443941193584534,9,3,non-aligned,non-aligned
24,study7Line,5.0,8,12,1928,13,stackbar,set1,-1,1,False,0.16992500144231237,12,0,start0,aligned
24,study7Line,6.0,9,45,1929,43,stackbar,set1,2,2,False,1.0874628412503393,7,0,start0,aligned
24,study7Line,9.0,10,26,1930,26,stackbar,set1,0,0,True,-3.0,1,0,start0,aligned
24,study7Line,10.0,11,16,1931,17,stackbar,set2,-1,1,False,0.16992500144231237,8,5,non-aligned,non-aligned
24,study7Line,7.0,12,48,1932,49,stackbar,set3,-1,1,False,0.16992500144231237,1,1,non-aligned,non-aligned
24,study7Line,4.0,13,48,1933,48,stackbar,set2,0,0,True,-3.0,2,0,start0,aligned
24,study7Line,5.0,14,40,1934,42,stackbar,set1,-2,2,False,1.0874628412503393,8,0,start0,aligned
24,study7Line,9.0,15,10,1935,11,stackbar,set1,-1,1,False,0.16992500144231237,11,4,non-aligned,non-aligned
24,study7Line,4.0,16,45,1936,45,stackbar,set2,0,0,True,-3.0,5,0,start0,aligned
24,study7Line,3.0,17,30,1937,27,stackbar,set4,3,3,False,1.6438561897747246,2,3,non-aligned,non-aligned
24,study7Line,6.0,18,39,1938,38,stackbar,set4,1,1,False,0.16992500144231237,12,0,start0,aligned
24,study7Line,6.0,19,32,1939,33,stackbar,set4,-1,1,False,0.16992500144231237,8,0,start0,aligned
24,study7Line,4.0,20,20,1940,18,stackbar,set4,2,2,False,1.0874628412503393,7,3,non-aligned,non-aligned
24,study7Line,6.0,21,14,1941,15,stackbar,set1,-1,1,False,0.16992500144231237,10,5,non-aligned,non-aligned
24,study7Line,7.0,22,38,1942,37,stackbar,set3,1,1,False,0.16992500144231237,12,0,start25,aligned
24,study7Line,4.0,23,44,1943,46,stackbar,set2,-2,2,False,1.0874628412503393,4,0,start0,aligned
24,study7Line,5.0,24,32,1944,33,stackbar,set3,-1,1,False,0.16992500144231237,8,3,non-aligned,non-aligned
24,study7Line,5.0,25,13,1945,15,stackbar,set2,-2,2,False,1.0874628412503393,10,0,start0,aligned
24,study7Line,8.0,26,36,1946,40,stackbar,set1,-4,4,False,2.0443941193584534,10,6,non-aligned,non-aligned
24,study7Line,4.0,27,28,1947,29,stackbar,set1,-1,1,False,0.16992500144231237,4,0,start0,aligned
24,study7Line,7.0,28,21,1948,20,stackbar,set1,1,1,False,0.16992500144231237,5,0,start75,aligned
24,study7Line,8.0,29,48,1949,47,stackbar,set2,1,1,False,0.16992500144231237,3,2,non-aligned,non-aligned
24,study7Line,5.0,30,38,1950,36,stackbar,set1,2,2,False,1.0874628412503393,11,0,start0,aligned
24,study7Line,8.0,31,49,1951,50,stackbar,set2,-1,1,False,0.16992500144231237,0,4,non-aligned,non-aligned
24,study7Line,4.0,32,50,1952,50,stackbar,set3,0,0,True,-3.0,0,0,start0,aligned
24,study7Line,4.0,33,12,1953,11,stackbar,set2,1,1,False,0.16992500144231237,11,0,start0,aligned
24,study7Line,7.0,34,23,1954,21,stackbar,set1,2,2,False,1.0874628412503393,4,1,non-aligned,non-aligned
24,study7Line,6.0,35,28,1955,30,stackbar,set2,-2,2,False,1.0874628412503393,5,4,non-aligned,non-aligned
24,study7Line,3.0,36,28,1956,28,stackbar,set4,0,0,True,-3.0,3,0,start0,aligned
24,study7Line,5.0,37,31,1957,32,stackbar,set1,-1,1,False,0.16992500144231237,7,0,start0,aligned
24,study7Line,4.0,38,20,1958,20,stackbar,set4,0,0,True,-3.0,5,0,start0,aligned
24,study7Line,10.0,39,42,1959,42,stackbar,set4,0,0,True,-3.0,8,1,non-aligned,non-aligned
24,study7Line,8.0,40,42,1960,43,stackbar,set1,-1,1,False,0.16992500144231237,7,2,non-aligned,non-aligned
24,study7Line,6.0,41,17,1961,17,stackbar,set3,0,0,True,-3.0,8,0,start0,aligned
24,study7Line,8.0,42,47,1962,48,stackbar,set2,-1,1,False,0.16992500144231237,2,2,non-aligned,non-aligned
24,study7Line,4.0,43,33,1963,34,stackbar,set3,-1,1,False,0.16992500144231237,9,0,start0,aligned
24,study7Line,12.0,44,40,1964,38,stackbar,set4,2,2,False,1.0874628412503393,12,6,non-aligned,non-aligned
24,study7Line,4.0,45,20,1965,19,stackbar,set3,1,1,False,0.16992500144231237,6,0,start0,aligned
24,study7Line,9.0,46,42,1966,44,stackbar,set1,-2,2,False,1.0874628412503393,6,2,non-aligned,non-aligned
24,study7Line,9.0,47,27,1967,28,stackbar,set3,-1,1,False,0.16992500144231237,3,9,non-aligned,non-aligned
24,study7Line,4.0,48,32,1968,35,stackbar,set4,-3,3,False,1.6438561897747246,10,0,start0,aligned
24,study7Line,5.0,49,38,1969,37,stackbar,set3,1,1,False,0.16992500144231237,12,0,start0,aligned
24,study7Line,6.0,50,20,1970,23,stackbar,set2,-3,3,False,1.6438561897747246,2,5,non-aligned,non-aligned
24,study7Line,6.0,51,44,1971,44,stackbar,set2,0,0,True,-3.0,6,0,start0,aligned
24,study7Line,5.0,52,30,1972,30,stackbar,set1,0,0,True,-3.0,5,0,start0,aligned
24,study7Line,3.0,53,10,1973,12,stackbar,set4,-2,2,False,1.0874628412503393,12,0,start0,aligned
24,study7Line,9.0,54,35,1974,36,stackbar,set4,-1,1,False,0.16992500144231237,11,3,non-aligned,non-aligned
24,study7Line,6.0,55,45,1975,46,stackbar,set2,-1,1,False,0.16992500144231237,4,9,non-aligned,non-aligned
24,study7Line,7.0,56,17,1976,16,stackbar,set1,1,1,False,0.16992500144231237,9,1,non-aligned,non-aligned
24,study7Line,7.0,57,40,1977,39,stackbar,set2,1,1,False,0.16992500144231237,11,1,non-aligned,non-aligned
24,study7Line,5.0,58,19,1978,18,stackbar,set1,1,1,False,0.16992500144231237,7,0,start0,aligned
24,study7Line,3.0,59,24,1979,24,stackbar,set3,0,0,True,-3.0,1,0,start0,aligned
24,study7Line,8.0,60,13,1980,14,stackbar,set1,-1,1,False,0.16992500144231237,11,5,non-aligned,non-aligned
24,study7Line,6.0,61,21,1981,21,stackbar,set2,0,0,True,-3.0,4,0,start0,aligned
24,study7Line,6.0,62,23,1982,23,stackbar,set4,0,0,True,-3.0,2,0,start0,aligned
24,study7Line,6.0,63,41,1983,39,stackbar,set4,2,2,False,1.0874628412503393,11,0,start0,aligned
24,study7Line,6.0,64,26,1984,26,stackbar,set4,0,0,True,-3.0,1,1,non-aligned,non-aligned
24,study7Line,6.0,65,43,1985,41,stackbar,set2,2,2,False,1.0874628412503393,9,0,start0,aligned
24,study7Line,4.0,66,17,1986,16,stackbar,set3,1,1,False,0.16992500144231237,9,0,start0,aligned
24,study7Line,7.0,67,30,1987,31,stackbar,set4,-1,1,False,0.16992500144231237,6,0,start0,aligned
24,study7Line,3.0,68,23,1988,22,stackbar,set4,1,1,False,0.16992500144231237,3,0,start0,aligned
24,study7Line,7.0,69,13,1989,14,stackbar,set3,-1,1,False,0.16992500144231237,11,0,start0,aligned
24,study7Line,6.0,70,32,1990,32,stackbar,set3,0,0,True,-3.0,7,2,non-aligned,non-aligned
24,study7Line,8.0,71,43,1991,45,stackbar,set2,-2,2,False,1.0874628412503393,5,9,non-aligned,non-aligned
24,study7Line,6.0,72,40,1992,40,stackbar,set3,0,0,True,-3.0,10,0,start0,aligned
24,study7Line,6.0,73,12,1993,12,stackbar,set4,0,0,True,-3.0,12,6,non-aligned,non-aligned
24,study7Line,4.0,74,27,1994,27,stackbar,set4,0,0,True,-3.0,2,0,start0,aligned
24,study7Line,4.0,75,47,1995,47,stackbar,set2,0,0,True,-3.0,3,0,start0,aligned
24,study7Line,6.0,76,12,1996,13,stackbar,set2,-1,1,False,0.16992500144231237,12,6,non-aligned,non-aligned
24,study7Line,13.0,77,18,1997,19,stackbar,set3,-1,1,False,0.16992500144231237,6,1,non-aligned,non-aligned
24,study7Line,5.0,78,49,1998,49,stackbar,set2,0,0,True,-3.0,1,0,start0,aligned
24,study7Line,8.0,79,26,1999,24,stackbar,set1,2,2,False,1.0874628412503393,1,5,non-aligned,non-aligned
13,study7Line,18.0,0,30,1040,29,stackbar,set1,1,1,False,0.16992500144231237,4,2,non-aligned,non-aligned
13,study7Line,16.0,1,45,1041,36,stackbar,set3,9,9,False,3.189824558880017,11,3,non-aligned,non-aligned
13,study7Line,15.0,2,40,1042,43,stackbar,set1,-3,3,False,1.6438561897747246,7,2,non-aligned,non-aligned
13,study7Line,10.0,3,20,1043,20,stackbar,set4,0,0,True,-3.0,5,0,start0,aligned
13,study7Line,10.0,4,50,1044,50,stackbar,set2,0,0,True,-3.0,0,0,start0,aligned
13,study7Line,11.0,5,20,1045,22,stackbar,set4,-2,2,False,1.0874628412503393,3,0,start75,aligned
13,study7Line,18.0,6,35,1046,38,stackbar,set3,-3,3,False,1.6438561897747246,12,3,non-aligned,non-aligned
13,study7Line,19.0,7,35,1047,30,stackbar,set3,5,5,False,2.357552004618084,5,0,start0,aligned
13,study7Line,11.0,8,26,1048,26,stackbar,set3,0,0,True,-3.0,1,0,start0,aligned
13,study7Line,11.0,9,12,1049,11,stackbar,set2,1,1,False,0.16992500144231237,11,0,start0,aligned
13,study7Line,35.0,10,34,1050,35,stackbar,set4,-1,1,False,0.16992500144231237,10,0,end100,aligned
13,study7Line,9.0,11,15,1051,17,stackbar,set4,-2,2,False,1.0874628412503393,8,1,non-aligned,non-aligned
13,study7Line,8.0,12,23,1052,23,stackbar,set2,0,0,True,-3.0,2,0,start0,aligned
13,study7Line,10.0,13,18,1053,18,stackbar,set3,0,0,True,-3.0,7,0,start0,aligned
13,study7Line,10.0,14,50,1054,50,stackbar,set2,0,0,True,-3.0,0,4,non-aligned,non-aligned
13,study7Line,11.0,15,13,1055,14,stackbar,set3,-1,1,False,0.16992500144231237,11,2,non-aligned,non-aligned
13,study7Line,12.0,16,41,1056,42,stackbar,set2,-1,1,False,0.16992500144231237,8,0,start0,aligned
13,study7Line,17.0,17,38,1057,37,stackbar,set2,1,1,False,0.16992500144231237,12,5,non-aligned,non-aligned
13,study7Line,14.0,18,32,1058,33,stackbar,set1,-1,1,False,0.16992500144231237,8,6,non-aligned,non-aligned
13,study7Line,17.0,19,36,1059,36,stackbar,set1,0,0,True,-3.0,11,0,start0,aligned
13,study7Line,9.0,20,29,1060,31,stackbar,set4,-2,2,False,1.0874628412503393,6,0,end50,aligned
13,study7Line,11.0,21,11,1061,15,stackbar,set4,-4,4,False,2.0443941193584534,10,0,start0,aligned
13,study7Line,21.0,22,54,1062,48,stackbar,set1,6,6,False,2.6147098441152083,2,9,non-aligned,non-aligned
13,study7Line,10.0,23,25,1063,25,stackbar,set4,0,0,True,-3.0,0,0,start0,aligned
13,study7Line,12.0,24,51,1064,49,stackbar,set4,2,2,False,1.0874628412503393,1,5,non-aligned,non-aligned
13,study7Line,10.0,25,44,1065,44,stackbar,set4,0,0,True,-3.0,6,2,non-aligned,non-aligned
13,study7Line,11.0,26,19,1066,21,stackbar,set1,-2,2,False,1.0874628412503393,4,1,non-aligned,non-aligned
13,study7Line,10.0,27,10,1067,12,stackbar,set3,-2,2,False,1.0874628412503393,12,1,non-aligned,non-aligned
13,study7Line,9.0,28,33,1068,34,stackbar,set4,-1,1,False,0.16992500144231237,9,0,start0,aligned
13,study7Line,15.0,29,43,1069,45,stackbar,set1,-2,2,False,1.0874628412503393,5,2,non-aligned,non-aligned
13,study7Line,12.0,30,37,1070,35,stackbar,set1,2,2,False,1.0874628412503393,10,0,start0,aligned
13,study7Line,14.0,31,22,1071,22,stackbar,set1,0,0,True,-3.0,3,0,start0,aligned
13,study7Line,17.0,32,12,1072,11,stackbar,set3,1,1,False,0.16992500144231237,11,5,non-aligned,non-aligned
13,study7Line,11.0,33,41,1073,44,stackbar,set2,-3,3,False,1.6438561897747246,6,0,start0,aligned
13,study7Line,23.0,34,37,1074,34,stackbar,set4,3,3,False,1.6438561897747246,9,2,non-aligned,non-aligned
13,study7Line,9.0,35,20,1075,21,stackbar,set3,-1,1,False,0.16992500144231237,4,0,start0,aligned
13,study7Line,9.0,36,16,1076,17,stackbar,set2,-1,1,False,0.16992500144231237,8,0,start0,aligned
13,study7Line,13.0,37,32,1077,26,stackbar,set2,6,6,False,2.6147098441152083,1,10,non-aligned,non-aligned
13,study7Line,21.0,38,46,1078,40,stackbar,set1,6,6,False,2.6147098441152083,10,6,non-aligned,non-aligned
13,study7Line,8.0,39,39,1079,41,stackbar,set2,-2,2,False,1.0874628412503393,9,0,start0,aligned
13,study7Line,26.0,40,44,1080,46,stackbar,set3,-2,2,False,1.0874628412503393,4,0,start0,aligned
13,study7Line,8.0,41,17,1081,19,stackbar,set2,-2,2,False,1.0874628412503393,6,0,start0,aligned
13,study7Line,17.0,42,31,1082,30,stackbar,set4,1,1,False,0.16992500144231237,5,1,non-aligned,non-aligned
13,study7Line,7.0,43,30,1083,29,stackbar,set4,1,1,False,0.16992500144231237,4,0,start0,aligned
13,study7Line,17.0,44,34,1084,37,stackbar,set4,-3,3,False,1.6438561897747246,12,0,start0,aligned
13,study7Line,27.0,45,52,1085,47,stackbar,set4,5,5,False,2.357552004618084,3,10,non-aligned,non-aligned
13,study7Line,8.0,46,20,1086,19,stackbar,set3,1,1,False,0.16992500144231237,6,1,non-aligned,non-aligned
13,study7Line,9.0,47,27,1087,28,stackbar,set2,-1,1,False,0.16992500144231237,3,0,start0,aligned
13,study7Line,8.0,48,18,1088,18,stackbar,set3,0,0,True,-3.0,7,2,non-aligned,non-aligned
13,study7Line,8.0,49,10,1089,13,stackbar,set4,-3,3,False,1.6438561897747246,12,6,non-aligned,non-aligned
13,study7Line,17.0,50,25,1090,25,stackbar,set1,0,0,True,-3.0,0,7,non-aligned,non-aligned
13,study7Line,11.0,51,39,1091,41,stackbar,set1,-2,2,False,1.0874628412503393,9,6,non-aligned,non-aligned
13,study7Line,11.0,52,44,1092,43,stackbar,set2,1,1,False,0.16992500144231237,7,0,start0,aligned
13,study7Line,25.0,53,29,1093,28,stackbar,set1,1,1,False,0.16992500144231237,3,10,non-aligned,non-aligned
13,study7Line,8.0,54,24,1094,24,stackbar,set1,0,0,True,-3.0,1,0,start0,aligned
13,study7Line,10.0,55,14,1095,16,stackbar,set4,-2,2,False,1.0874628412503393,9,0,start0,aligned
13,study7Line,19.0,56,47,1096,46,stackbar,set4,1,1,False,0.16992500144231237,4,2,non-aligned,non-aligned
13,study7Line,13.0,57,36,1097,38,stackbar,set4,-2,2,False,1.0874628412503393,12,0,start0,aligned
13,study7Line,23.0,58,22,1098,23,stackbar,set4,-1,1,False,0.16992500144231237,2,10,non-aligned,non-aligned
13,study7Line,7.0,59,49,1099,49,stackbar,set4,0,0,True,-3.0,1,0,start0,aligned
13,study7Line,12.0,60,31,1100,33,stackbar,set1,-2,2,False,1.0874628412503393,8,0,start0,aligned
13,study7Line,19.0,61,36,1101,39,stackbar,set1,-3,3,False,1.6438561897747246,11,4,non-aligned,non-aligned
13,study7Line,13.0,62,14,1102,14,stackbar,set4,0,0,True,-3.0,11,0,start0,aligned
13,study7Line,9.0,63,47,1103,48,stackbar,set3,-1,1,False,0.16992500144231237,2,0,start0,aligned
13,study7Line,16.0,64,30,1104,31,stackbar,set1,-1,1,False,0.16992500144231237,6,0,start0,aligned
13,study7Line,19.0,65,27,1105,27,stackbar,set1,0,0,True,-3.0,2,2,non-aligned,non-aligned
13,study7Line,16.0,66,15,1106,15,stackbar,set2,0,0,True,-3.0,10,4,non-aligned,non-aligned
13,study7Line,9.0,67,27,1107,27,stackbar,set4,0,0,True,-3.0,2,0,start0,aligned
13,study7Line,20.0,68,46,1108,47,stackbar,set3,-1,1,False,0.16992500144231237,3,0,start0,aligned
13,study7Line,50.0,69,12,1109,13,stackbar,set2,-1,1,False,0.16992500144231237,12,0,start0,aligned
13,study7Line,48.0,70,22,1110,24,stackbar,set2,-2,2,False,1.0874628412503393,1,2,non-aligned,non-aligned
13,study7Line,18.0,71,38,1111,40,stackbar,set3,-2,2,False,1.0874628412503393,10,0,start0,aligned
13,study7Line,12.0,72,31,1112,32,stackbar,set3,-1,1,False,0.16992500144231237,7,0,start0,aligned
13,study7Line,11.0,73,16,1113,16,stackbar,set1,0,0,True,-3.0,9,1,non-aligned,non-aligned
13,study7Line,29.0,74,40,1114,42,stackbar,set2,-2,2,False,1.0874628412503393,8,4,non-aligned,non-aligned
13,study7Line,23.0,75,36,1115,32,stackbar,set1,4,4,False,2.0443941193584534,7,2,non-aligned,non-aligned
13,study7Line,11.0,76,42,1116,45,stackbar,set4,-3,3,False,1.6438561897747246,5,0,start0,aligned
13,study7Line,13.0,77,38,1117,39,stackbar,set3,-1,1,False,0.16992500144231237,11,0,start0,aligned
13,study7Line,14.0,78,18,1118,20,stackbar,set3,-2,2,False,1.0874628412503393,5,2,non-aligned,non-aligned
13,study7Line,14.0,79,9,1119,12,stackbar,set4,-3,3,False,1.6438561897747246,12,0,start0,aligned
21,study7Line,13.0,0,30,1680,44,stackbar,set4,-14,14,False,3.820178962415188,6,2,non-aligned,non-aligned
21,study7Line,7.0,1,20,1681,20,stackbar,set1,0,0,True,-3.0,5,0,start0,aligned
21,study7Line,7.0,2,35,1682,41,stackbar,set2,-6,6,False,2.6147098441152083,9,4,non-aligned,non-aligned
21,study7Line,9.0,3,15,1683,15,stackbar,set4,0,0,True,-3.0,10,0,start0,aligned
21,study7Line,5.0,4,15,1684,23,stackbar,set4,-8,8,False,3.0223678130284544,2,10,non-aligned,non-aligned
21,study7Line,12.0,5,45,1685,49,stackbar,set3,-4,4,False,2.0443941193584534,1,1,non-aligned,non-aligned
21,study7Line,7.0,6,35,1686,45,stackbar,set1,-10,10,False,3.3398500028846247,5,2,non-aligned,non-aligned
21,study7Line,5.0,7,22,1687,21,stackbar,set4,1,1,False,0.16992500144231237,4,0,start0,aligned
21,study7Line,7.0,8,34,1688,37,stackbar,set3,-3,3,False,1.6438561897747246,12,0,start0,aligned
21,study7Line,7.0,9,40,1689,42,stackbar,set4,-2,2,False,1.0874628412503393,8,0,start0,aligned
21,study7Line,8.0,10,40,1690,46,stackbar,set4,-6,6,False,2.6147098441152083,4,2,non-aligned,non-aligned
21,study7Line,5.0,11,45,1691,46,stackbar,set1,-1,1,False,0.16992500144231237,4,0,start0,aligned
21,study7Line,7.0,12,25,1692,27,stackbar,set4,-2,2,False,1.0874628412503393,2,3,non-aligned,non-aligned
21,study7Line,7.0,13,50,1693,50,stackbar,set2,0,0,True,-3.0,0,0,start0,aligned
21,study7Line,7.0,14,20,1694,14,stackbar,set3,6,6,False,2.6147098441152083,11,2,non-aligned,non-aligned
21,study7Line,6.0,15,47,1695,49,stackbar,set2,-2,2,False,1.0874628412503393,1,0,start0,aligned
21,study7Line,8.0,16,12,1696,14,stackbar,set1,-2,2,False,1.0874628412503393,11,0,start0,aligned
21,study7Line,4.0,17,13,1697,16,stackbar,set4,-3,3,False,1.6438561897747246,9,0,start0,aligned
21,study7Line,6.0,18,30,1698,32,stackbar,set2,-2,2,False,1.0874628412503393,7,6,non-aligned,non-aligned
21,study7Line,4.0,19,35,1699,33,stackbar,set1,2,2,False,1.0874628412503393,8,0,start0,aligned
21,study7Line,3.0,20,25,1700,25,stackbar,set3,0,0,True,-3.0,0,0,start0,aligned
21,study7Line,3.0,21,27,1701,26,stackbar,set2,1,1,False,0.16992500144231237,1,0,start0,aligned
21,study7Line,6.0,22,36,1702,33,stackbar,set3,3,3,False,1.6438561897747246,8,3,non-aligned,non-aligned
21,study7Line,6.0,23,35,1703,34,stackbar,set1,1,1,False,0.16992500144231237,9,0,start0,aligned
21,study7Line,7.0,24,43,1704,45,stackbar,set1,-2,2,False,1.0874628412503393,5,0,start0,aligned
21,study7Line,17.0,25,36,1705,40,stackbar,set3,-4,4,False,2.0443941193584534,10,0,start0,aligned
21,study7Line,7.0,26,27,1706,27,stackbar,set2,0,0,True,-3.0,2,0,start0,aligned
21,study7Line,5.0,27,25,1707,25,stackbar,set2,0,0,True,-3.0,0,8,non-aligned,non-aligned
21,study7Line,12.0,28,35,1708,38,stackbar,set4,-3,3,False,1.6438561897747246,12,6,non-aligned,non-aligned
21,study7Line,5.0,29,50,1709,50,stackbar,set2,0,0,True,-3.0,0,4,non-aligned,non-aligned
21,study7Line,4.0,30,30,1710,30,stackbar,set1,0,0,True,-3.0,5,0,start0,aligned
21,study7Line,5.0,31,46,1711,47,stackbar,set2,-1,1,False,0.16992500144231237,3,0,start0,aligned
21,study7Line,8.0,32,40,1712,42,stackbar,set4,-2,2,False,1.0874628412503393,8,1,non-aligned,non-aligned
21,study7Line,5.0,33,35,1713,36,stackbar,set4,-1,1,False,0.16992500144231237,11,3,non-aligned,non-aligned
21,study7Line,4.0,34,30,1714,31,stackbar,set2,-1,1,False,0.16992500144231237,6,0,start0,aligned
21,study7Line,5.0,35,25,1715,29,stackbar,set3,-4,4,False,2.0443941193584534,4,9,non-aligned,non-aligned
21,study7Line,11.0,36,30,1716,37,stackbar,set2,-7,7,False,2.8328900141647417,12,5,non-aligned,non-aligned
21,study7Line,6.0,37,18,1717,19,stackbar,set3,-1,1,False,0.16992500144231237,6,0,start0,aligned
21,study7Line,5.0,38,15,1718,17,stackbar,set1,-2,2,False,1.0874628412503393,8,0,start0,aligned
21,study7Line,7.0,39,18,1719,20,stackbar,set3,-2,2,False,1.0874628412503393,5,2,non-aligned,non-aligned
21,study7Line,4.0,40,47,1720,48,stackbar,set2,-1,1,False,0.16992500144231237,2,0,start0,aligned
21,study7Line,5.0,41,14,1721,13,stackbar,set2,1,1,False,0.16992500144231237,12,0,start0,aligned
21,study7Line,7.0,42,35,1722,43,stackbar,set3,-8,8,False,3.0223678130284544,7,3,non-aligned,non-aligned
21,study7Line,5.0,43,22,1723,22,stackbar,set1,0,0,True,-3.0,3,0,start0,aligned
21,study7Line,4.0,44,45,1724,43,stackbar,set2,2,2,False,1.0874628412503393,7,0,start0,aligned
21,study7Line,5.0,45,18,1725,16,stackbar,set1,2,2,False,1.0874628412503393,9,1,non-aligned,non-aligned
21,study7Line,7.0,46,30,1726,30,stackbar,set2,0,0,True,-3.0,5,4,non-aligned,non-aligned
21,study7Line,4.0,47,29,1727,28,stackbar,set4,1,1,False,0.16992500144231237,3,0,start0,aligned
21,study7Line,3.0,48,10,1728,11,stackbar,set2,-1,1,False,0.16992500144231237,11,2,non-aligned,non-aligned
21,study7Line,4.0,49,15,1729,12,stackbar,set2,3,3,False,1.6438561897747246,12,1,non-aligned,non-aligned
21,study7Line,5.0,50,40,1730,41,stackbar,set1,-1,1,False,0.16992500144231237,9,0,start0,aligned
21,study7Line,15.0,51,35,1731,35,stackbar,set1,0,0,True,-3.0,10,0,start0,aligned
21,study7Line,8.0,52,15,1732,13,stackbar,set1,2,2,False,1.0874628412503393,12,6,non-aligned,non-aligned
21,study7Line,20.0,53,40,1733,40,stackbar,set2,0,0,True,-3.0,10,1,non-aligned,non-aligned
21,study7Line,8.0,54,20,1734,19,stackbar,set1,1,1,False,0.16992500144231237,6,8,non-aligned,non-aligned
21,study7Line,5.0,55,12,1735,12,stackbar,set3,0,0,True,-3.0,12,0,start0,aligned
21,study7Line,8.0,56,20,1736,22,stackbar,set4,-2,2,False,1.0874628412503393,3,0,start75,aligned
21,study7Line,18.0,57,25,1737,26,stackbar,set2,-1,1,False,0.16992500144231237,1,10,non-aligned,non-aligned
21,study7Line,15.0,58,35,1738,34,stackbar,set3,1,1,False,0.16992500144231237,9,3,non-aligned,non-aligned
21,study7Line,10.0,59,45,1739,47,stackbar,set3,-2,2,False,1.0874628412503393,3,10,non-aligned,non-aligned
21,study7Line,7.0,60,35,1740,39,stackbar,set1,-4,4,False,2.0443941193584534,11,4,non-aligned,non-aligned
21,study7Line,12.0,61,23,1741,24,stackbar,set1,-1,1,False,0.16992500144231237,1,0,start0,aligned
21,study7Line,8.0,62,10,1742,11,stackbar,set1,-1,1,False,0.16992500144231237,11,0,start0,aligned
21,study7Line,4.0,63,20,1743,24,stackbar,set3,-4,4,False,2.0443941193584534,1,8,non-aligned,non-aligned
21,study7Line,6.0,64,15,1744,18,stackbar,set1,-3,3,False,1.6438561897747246,7,0,start0,aligned
21,study7Line,9.0,65,42,1745,44,stackbar,set3,-2,2,False,1.0874628412503393,6,0,start0,aligned
21,study7Line,6.0,66,50,1746,48,stackbar,set4,2,2,False,1.0874628412503393,2,2,non-aligned,non-aligned
21,study7Line,11.0,67,15,1747,17,stackbar,set3,-2,2,False,1.0874628412503393,8,3,non-aligned,non-aligned
21,study7Line,13.0,68,34,1748,39,stackbar,set1,-5,5,False,2.357552004618084,11,0,start0,aligned
21,study7Line,6.0,69,25,1749,28,stackbar,set1,-3,3,False,1.6438561897747246,3,10,non-aligned,non-aligned
21,study7Line,3.0,70,22,1750,23,stackbar,set2,-1,1,False,0.16992500144231237,2,0,start0,aligned
21,study7Line,8.0,71,15,1751,15,stackbar,set2,0,0,True,-3.0,10,4,non-aligned,non-aligned
21,study7Line,13.0,72,35,1752,36,stackbar,set4,-1,1,False,0.16992500144231237,11,0,start0,aligned
21,study7Line,6.0,73,35,1753,38,stackbar,set2,-3,3,False,1.6438561897747246,12,0,start0,aligned
21,study7Line,5.0,74,30,1754,32,stackbar,set1,-2,2,False,1.0874628412503393,7,0,start0,aligned
21,study7Line,5.0,75,16,1755,18,stackbar,set2,-2,2,False,1.0874628412503393,7,1,non-aligned,non-aligned
21,study7Line,5.0,76,30,1756,31,stackbar,set3,-1,1,False,0.16992500144231237,6,2,non-aligned,non-aligned
21,study7Line,9.0,77,35,1757,35,stackbar,set1,0,0,True,-3.0,10,6,non-aligned,non-aligned
21,study7Line,4.0,78,27,1758,29,stackbar,set4,-2,2,False,1.0874628412503393,4,0,start0,aligned
21,study7Line,10.0,79,20,1759,21,stackbar,set2,-1,1,False,0.16992500144231237,4,6,non-aligned,non-aligned
7,study7Line,12.0,0,22,560,21,stackbar,set3,1,1,False,0.16992500144231237,4,0,start0,aligned
7,study7Line,18.0,1,33,561,34,stackbar,set1,-1,1,False,0.16992500144231237,9,0,start0,aligned
7,study7Line,14.0,2,23,562,22,stackbar,set4,1,1,False,0.16992500144231237,3,0,start0,aligned
7,study7Line,41.0,3,12,563,11,stackbar,set2,1,1,False,0.16992500144231237,11,2,non-aligned,non-aligned
7,study7Line,22.0,4,45,564,43,stackbar,set1,2,2,False,1.0874628412503393,7,0,start0,aligned
7,study7Line,13.0,5,30,565,33,stackbar,set3,-3,3,False,1.6438561897747246,8,0,start0,aligned
7,study7Line,23.0,6,25,566,24,stackbar,set1,1,1,False,0.16992500144231237,1,5,non-aligned,non-aligned
7,study7Line,22.0,7,26,567,26,stackbar,set4,0,0,True,-3.0,1,0,start0,aligned
7,study7Line,31.0,8,47,568,45,stackbar,set3,2,2,False,1.0874628412503393,5,0,start0,aligned
7,study7Line,13.0,9,12,569,13,stackbar,set3,-1,1,False,0.16992500144231237,12,0,start0,aligned
7,study7Line,6.0,10,27,570,29,stackbar,set2,-2,2,False,1.0874628412503393,4,0,start0,aligned
7,study7Line,6.0,11,40,571,42,stackbar,set2,-2,2,False,1.0874628412503393,8,0,start0,aligned
7,study7Line,154.0,12,20,572,14,stackbar,set3,6,6,False,2.6147098441152083,11,2,non-aligned,non-aligned
7,study7Line,27.0,13,20,573,20,stackbar,set3,0,0,True,-3.0,5,2,non-aligned,non-aligned
7,study7Line,9.0,14,38,574,39,stackbar,set3,-1,1,False,0.16992500144231237,11,0,start0,aligned
7,study7Line,42.0,15,10,575,11,stackbar,set1,-1,1,False,0.16992500144231237,11,0,start0,aligned
7,study7Line,9.0,16,14,576,12,stackbar,set3,2,2,False,1.0874628412503393,12,1,non-aligned,non-aligned
7,study7Line,6.0,17,47,577,47,stackbar,set4,0,0,True,-3.0,3,0,start0,aligned
7,study7Line,43.0,18,25,578,23,stackbar,set2,2,2,False,1.0874628412503393,2,5,non-aligned,non-aligned
7,study7Line,7.0,19,27,579,28,stackbar,set1,-1,1,False,0.16992500144231237,3,0,start0,aligned
7,study7Line,10.0,20,40,580,41,stackbar,set4,-1,1,False,0.16992500144231237,9,0,start0,aligned
7,study7Line,9.0,21,35,581,37,stackbar,set4,-2,2,False,1.0874628412503393,12,1,non-aligned,non-aligned
7,study7Line,41.0,22,23,582,23,stackbar,set4,0,0,True,-3.0,2,0,start0,aligned
7,study7Line,8.0,23,45,583,40,stackbar,set4,5,5,False,2.357552004618084,10,2,non-aligned,non-aligned
7,study7Line,9.0,24,40,584,40,stackbar,set4,0,0,True,-3.0,10,0,start0,aligned
7,study7Line,6.0,25,50,585,49,stackbar,set4,1,1,False,0.16992500144231237,1,5,non-aligned,non-aligned
7,study7Line,10.0,26,45,586,45,stackbar,set4,0,0,True,-3.0,5,7,non-aligned,non-aligned
7,study7Line,10.0,27,30,587,27,stackbar,set3,3,3,False,1.6438561897747246,2,6,non-aligned,non-aligned
7,study7Line,10.0,28,30,588,28,stackbar,set3,2,2,False,1.0874628412503393,3,9,non-aligned,non-aligned
7,study7Line,18.0,29,30,589,34,stackbar,set4,-4,4,False,2.0443941193584534,9,2,non-aligned,non-aligned
7,study7Line,42.0,30,20,590,16,stackbar,set1,4,4,False,2.0443941193584534,9,1,non-aligned,non-aligned
7,study7Line,6.0,31,48,591,49,stackbar,set2,-1,1,False,0.16992500144231237,1,0,start0,aligned
7,study7Line,21.0,32,30,592,38,stackbar,set1,-8,8,False,3.0223678130284544,12,1,non-aligned,non-aligned
7,study7Line,5.0,33,24,593,24,stackbar,set4,0,0,True,-3.0,1,0,start0,aligned
7,study7Line,8.0,34,28,594,26,stackbar,set3,2,2,False,1.0874628412503393,1,3,non-aligned,non-aligned
7,study7Line,14.0,35,33,595,32,stackbar,set3,1,1,False,0.16992500144231237,7,2,non-aligned,non-aligned
7,study7Line,43.0,36,18,596,18,stackbar,set4,0,0,True,-3.0,7,3,non-aligned,non-aligned
7,study7Line,13.0,37,45,597,46,stackbar,set2,-1,1,False,0.16992500144231237,4,0,start0,aligned
7,study7Line,9.0,38,36,598,37,stackbar,set1,-1,1,False,0.16992500144231237,12,0,start0,aligned
7,study7Line,43.0,39,48,599,48,stackbar,set2,0,0,True,-3.0,2,0,start0,aligned
7,study7Line,13.0,40,53,600,48,stackbar,set4,5,5,False,2.357552004618084,2,2,non-aligned,non-aligned
7,study7Line,6.0,41,25,601,25,stackbar,set4,0,0,True,-3.0,0,0,start0,aligned
7,study7Line,20.0,42,51,602,47,stackbar,set4,4,4,False,2.0443941193584534,3,10,non-aligned,non-aligned
7,study7Line,9.0,43,35,603,36,stackbar,set4,-1,1,False,0.16992500144231237,11,0,start0,aligned
7,study7Line,11.0,44,14,604,13,stackbar,set3,1,1,False,0.16992500144231237,12,2,non-aligned,non-aligned
7,study7Line,11.0,45,38,605,38,stackbar,set1,0,0,True,-3.0,12,0,start0,aligned
7,study7Line,7.0,46,10,606,12,stackbar,set4,-2,2,False,1.0874628412503393,12,0,start0,aligned
7,study7Line,14.0,47,50,607,39,stackbar,set2,11,11,False,3.4757334309663976,11,1,non-aligned,non-aligned
7,study7Line,6.0,48,30,608,31,stackbar,set1,-1,1,False,0.16992500144231237,6,0,start0,aligned
7,study7Line,8.0,49,25,609,25,stackbar,set2,0,0,True,-3.0,0,8,non-aligned,non-aligned
7,study7Line,6.0,50,17,610,17,stackbar,set4,0,0,True,-3.0,8,0,start0,aligned
7,study7Line,7.0,51,13,611,14,stackbar,set4,-1,1,False,0.16992500144231237,11,0,start0,aligned
7,study7Line,25.0,52,28,612,30,stackbar,set1,-2,2,False,1.0874628412503393,5,0,start0,aligned
7,study7Line,14.0,53,35,613,33,stackbar,set2,2,2,False,1.0874628412503393,8,8,non-aligned,non-aligned
7,study7Line,10.0,54,20,614,19,stackbar,set2,1,1,False,0.16992500144231237,6,0,start0,aligned
7,study7Line,5.0,55,13,615,15,stackbar,set4,-2,2,False,1.0874628412503393,10,0,start0,aligned
7,study7Line,6.0,56,30,616,31,stackbar,set4,-1,1,False,0.16992500144231237,6,0,end50,aligned
7,study7Line,5.0,57,20,617,18,stackbar,set2,2,2,False,1.0874628412503393,7,0,start0,aligned
7,study7Line,5.0,58,50,618,50,stackbar,set1,0,0,True,-3.0,0,0,start0,aligned
7,study7Line,17.0,59,40,619,36,stackbar,set1,4,4,False,2.0443941193584534,11,3,non-aligned,non-aligned
7,study7Line,8.0,60,50,620,50,stackbar,set3,0,0,True,-3.0,0,5,non-aligned,non-aligned
7,study7Line,8.0,61,83,621,35,stackbar,set1,48,48,False,5.588714635582264,10,6,non-aligned,non-aligned
7,study7Line,7.0,62,27,622,27,stackbar,set4,0,0,True,-3.0,2,0,start0,aligned
7,study7Line,21.0,63,33,623,29,stackbar,set3,4,4,False,2.0443941193584534,4,9,non-aligned,non-aligned
7,study7Line,29.0,64,30,624,30,stackbar,set2,0,0,True,-3.0,5,4,non-aligned,non-aligned
7,study7Line,7.0,65,45,625,42,stackbar,set2,3,3,False,1.6438561897747246,8,4,non-aligned,non-aligned
7,study7Line,6.0,66,25,626,21,stackbar,set2,4,4,False,2.0443941193584534,4,6,non-aligned,non-aligned
7,study7Line,6.0,67,32,627,32,stackbar,set2,0,0,True,-3.0,7,0,start0,aligned
7,study7Line,15.0,68,19,628,17,stackbar,set1,2,2,False,1.0874628412503393,8,0,start25,aligned
7,study7Line,10.0,69,21,629,19,stackbar,set4,2,2,False,1.0874628412503393,6,0,end75,aligned
7,study7Line,8.0,70,45,630,44,stackbar,set1,1,1,False,0.16992500144231237,6,2,non-aligned,non-aligned
7,study7Line,10.0,71,27,631,22,stackbar,set1,5,5,False,2.357552004618084,3,2,non-aligned,non-aligned
7,study7Line,9.0,72,45,632,44,stackbar,set1,1,1,False,0.16992500144231237,6,0,start0,aligned
7,study7Line,25.0,73,45,633,41,stackbar,set3,4,4,False,2.0443941193584534,9,1,non-aligned,non-aligned
7,study7Line,9.0,74,14,634,16,stackbar,set4,-2,2,False,1.0874628412503393,9,0,start0,aligned
7,study7Line,8.0,75,48,635,46,stackbar,set2,2,2,False,1.0874628412503393,4,9,non-aligned,non-aligned
7,study7Line,10.0,76,21,636,20,stackbar,set3,1,1,False,0.16992500144231237,5,0,start0,aligned
7,study7Line,6.0,77,33,637,35,stackbar,set2,-2,2,False,1.0874628412503393,10,0,start0,aligned
7,study7Line,10.0,78,28,638,43,stackbar,set4,-15,15,False,3.9188632372745946,7,6,non-aligned,non-aligned
7,study7Line,10.0,79,18,639,15,stackbar,set4,3,3,False,1.6438561897747246,10,4,non-aligned,non-aligned
34,study7Line,16.0,0,50,2720,42,stackbar,set4,8,8,False,3.0223678130284544,8,1,non-aligned,non-aligned
34,study7Line,11.0,1,10,2721,11,stackbar,set1,-1,1,False,0.16992500144231237,11,0,start0,aligned
34,study7Line,11.0,2,20,2722,17,stackbar,set3,3,3,False,1.6438561897747246,8,0,start0,aligned
34,study7Line,19.0,3,50,2723,49,stackbar,set4,1,1,False,0.16992500144231237,1,5,non-aligned,non-aligned
34,study7Line,13.0,4,28,2724,29,stackbar,set1,-1,1,False,0.16992500144231237,4,2,non-aligned,non-aligned
34,study7Line,16.0,5,40,2725,34,stackbar,set2,6,6,False,2.6147098441152083,9,2,non-aligned,non-aligned
34,study7Line,19.0,6,18,2726,22,stackbar,set2,-4,4,False,2.0443941193584534,3,9,non-aligned,non-aligned
34,study7Line,17.0,7,40,2727,39,stackbar,set3,1,1,False,0.16992500144231237,11,0,start0,aligned
34,study7Line,26.0,8,30,2728,30,stackbar,set3,0,0,True,-3.0,5,7,non-aligned,non-aligned
34,study7Line,11.0,9,48,2729,48,stackbar,set2,0,0,True,-3.0,2,0,start0,aligned
34,study7Line,13.0,10,50,2730,45,stackbar,set1,5,5,False,2.357552004618084,5,2,non-aligned,non-aligned
34,study7Line,11.0,11,50,2731,48,stackbar,set2,2,2,False,1.0874628412503393,2,2,non-aligned,non-aligned
34,study7Line,14.0,12,20,2732,15,stackbar,set3,5,5,False,2.357552004618084,10,3,non-aligned,non-aligned
34,study7Line,10.0,13,35,2733,33,stackbar,set3,2,2,False,1.0874628412503393,8,0,start0,aligned
34,study7Line,8.0,14,49,2734,49,stackbar,set1,0,0,True,-3.0,1,0,start0,aligned
34,study7Line,11.0,15,23,2735,22,stackbar,set3,1,1,False,0.16992500144231237,3,0,start0,aligned
34,study7Line,22.0,16,10,2736,12,stackbar,set2,-2,2,False,1.0874628412503393,12,0,start0,aligned
34,study7Line,15.0,17,30,2737,33,stackbar,set1,-3,3,False,1.6438561897747246,8,6,non-aligned,non-aligned
34,study7Line,9.0,18,24,2738,24,stackbar,set2,0,0,True,-3.0,1,0,start0,aligned
34,study7Line,9.0,19,45,2739,44,stackbar,set4,1,1,False,0.16992500144231237,6,0,start0,aligned
34,study7Line,6.0,20,26,2740,27,stackbar,set2,-1,1,False,0.16992500144231237,2,0,start0,aligned
34,study7Line,11.0,21,25,2741,25,stackbar,set2,0,0,True,-3.0,0,0,start0,aligned
34,study7Line,11.0,22,25,2742,25,stackbar,set3,0,0,True,-3.0,0,5,non-aligned,non-aligned
34,study7Line,10.0,23,25,2743,13,stackbar,set2,12,12,False,3.599912842187128,12,6,non-aligned,non-aligned
34,study7Line,11.0,24,13,2744,16,stackbar,set2,-3,3,False,1.6438561897747246,9,0,start0,aligned
34,study7Line,22.0,25,32,2745,35,stackbar,set3,-3,3,False,1.6438561897747246,10,0,start0,aligned
34,study7Line,7.0,26,45,2746,41,stackbar,set3,4,4,False,2.0443941193584534,9,0,start0,aligned
34,study7Line,13.0,27,43,2747,40,stackbar,set3,3,3,False,1.6438561897747246,10,0,start0,aligned
34,study7Line,18.0,28,40,2748,37,stackbar,set1,3,3,False,1.6438561897747246,12,6,non-aligned,non-aligned
34,study7Line,15.0,29,35,2749,37,stackbar,set2,-2,2,False,1.0874628412503393,12,0,start0,aligned
34,study7Line,11.0,30,22,2750,14,stackbar,set2,8,8,False,3.0223678130284544,11,4,non-aligned,non-aligned
34,study7Line,8.0,31,48,2751,47,stackbar,set4,1,1,False,0.16992500144231237,3,0,start0,aligned
34,study7Line,11.0,32,22,2752,20,stackbar,set3,2,2,False,1.0874628412503393,5,2,non-aligned,non-aligned
34,study7Line,6.0,33,27,2753,29,stackbar,set2,-2,2,False,1.0874628412503393,4,0,start0,aligned
34,study7Line,17.0,34,30,2754,35,stackbar,set3,-5,5,False,2.357552004618084,10,2,non-aligned,non-aligned
34,study7Line,20.0,35,35,2755,43,stackbar,set2,-8,8,False,3.0223678130284544,7,2,non-aligned,non-aligned
34,study7Line,11.0,36,50,2756,50,stackbar,set2,0,0,True,-3.0,0,0,start0,aligned
34,study7Line,12.0,37,20,2757,16,stackbar,set1,4,4,False,2.0443941193584534,9,1,non-aligned,non-aligned
34,study7Line,18.0,38,30,2758,38,stackbar,set2,-8,8,False,3.0223678130284544,12,5,non-aligned,non-aligned
34,study7Line,8.0,39,12,2759,13,stackbar,set4,-1,1,False,0.16992500144231237,12,0,start0,aligned
34,study7Line,8.0,40,26,2760,26,stackbar,set4,0,0,True,-3.0,1,0,start0,aligned
34,study7Line,13.0,41,33,2761,36,stackbar,set1,-3,3,False,1.6438561897747246,11,3,non-aligned,non-aligned
34,study7Line,6.0,42,45,2762,45,stackbar,set4,0,0,True,-3.0,5,0,start0,aligned
34,study7Line,9.0,43,37,2763,40,stackbar,set2,-3,3,False,1.6438561897747246,10,1,non-aligned,non-aligned
34,study7Line,14.0,44,22,2764,19,stackbar,set2,3,3,False,1.6438561897747246,6,2,non-aligned,non-aligned
34,study7Line,9.0,45,25,2765,21,stackbar,set2,4,4,False,2.0443941193584534,4,6,non-aligned,non-aligned
34,study7Line,8.0,46,25,2766,26,stackbar,set1,-1,1,False,0.16992500144231237,1,3,non-aligned,non-aligned
34,study7Line,8.0,47,14,2767,19,stackbar,set1,-5,5,False,2.357552004618084,6,0,start0,aligned
34,study7Line,10.0,48,12,2768,12,stackbar,set2,0,0,True,-3.0,12,1,non-aligned,non-aligned
34,study7Line,11.0,49,12,2769,11,stackbar,set3,1,1,False,0.16992500144231237,11,5,non-aligned,non-aligned
34,study7Line,7.0,50,45,2770,42,stackbar,set3,3,3,False,1.6438561897747246,8,0,start0,aligned
34,study7Line,6.0,51,11,2771,14,stackbar,set2,-3,3,False,1.6438561897747246,11,0,start0,aligned
34,study7Line,11.0,52,36,2772,36,stackbar,set3,0,0,True,-3.0,11,0,start0,aligned
34,study7Line,7.0,53,28,2773,30,stackbar,set1,-2,2,False,1.0874628412503393,5,0,start0,aligned
34,study7Line,5.0,54,12,2774,15,stackbar,set2,-3,3,False,1.6438561897747246,10,0,start0,aligned
34,study7Line,10.0,55,48,2775,46,stackbar,set4,2,2,False,1.0874628412503393,4,0,start0,aligned
34,study7Line,14.0,56,29,2776,34,stackbar,set1,-5,5,False,2.357552004618084,9,0,start0,aligned
34,study7Line,13.0,57,22,2777,18,stackbar,set1,4,4,False,2.0443941193584534,7,1,non-aligned,non-aligned
34,study7Line,6.0,58,47,2778,43,stackbar,set4,4,4,False,2.0443941193584534,7,0,start0,aligned
34,study7Line,10.0,59,25,2779,23,stackbar,set4,2,2,False,1.0874628412503393,2,10,non-aligned,non-aligned
34,study7Line,5.0,60,23,2780,20,stackbar,set2,3,3,False,1.6438561897747246,5,0,start0,aligned
34,study7Line,10.0,61,26,2781,27,stackbar,set1,-1,1,False,0.16992500144231237,2,2,non-aligned,non-aligned
34,study7Line,8.0,62,26,2782,28,stackbar,set4,-2,2,False,1.0874628412503393,3,5,non-aligned,non-aligned
34,study7Line,5.0,63,23,2783,21,stackbar,set2,2,2,False,1.0874628412503393,4,0,start0,aligned
34,study7Line,7.0,64,25,2784,24,stackbar,set4,1,1,False,0.16992500144231237,1,9,non-aligned,non-aligned
34,study7Line,13.0,65,32,2785,39,stackbar,set1,-7,7,False,2.8328900141647417,11,4,non-aligned,non-aligned
34,study7Line,16.0,66,39,2786,46,stackbar,set4,-7,7,False,2.8328900141647417,4,2,non-aligned,non-aligned
34,study7Line,6.0,67,26,2787,32,stackbar,set1,-6,6,False,2.6147098441152083,7,2,non-aligned,non-aligned
34,study7Line,10.0,68,50,2788,47,stackbar,set4,3,3,False,1.6438561897747246,3,10,non-aligned,non-aligned
34,study7Line,9.0,69,37,2789,38,stackbar,set4,-1,1,False,0.16992500144231237,12,0,start0,aligned
34,study7Line,18.0,70,32,2790,31,stackbar,set3,1,1,False,0.16992500144231237,6,0,start0,aligned
34,study7Line,10.0,71,34,2791,41,stackbar,set1,-7,7,False,2.8328900141647417,9,6,non-aligned,non-aligned
34,study7Line,12.0,72,15,2792,17,stackbar,set2,-2,2,False,1.0874628412503393,8,5,non-aligned,non-aligned
34,study7Line,7.0,73,24,2793,23,stackbar,set1,1,1,False,0.16992500144231237,2,0,start0,aligned
34,study7Line,14.0,74,29,2794,31,stackbar,set2,-2,2,False,1.0874628412503393,6,1,non-aligned,non-aligned
34,study7Line,10.0,75,35,2795,32,stackbar,set2,3,3,False,1.6438561897747246,7,0,start0,aligned
34,study7Line,8.0,76,14,2796,18,stackbar,set2,-4,4,False,2.0443941193584534,7,0,start0,aligned
34,study7Line,5.0,77,27,2797,28,stackbar,set3,-1,1,False,0.16992500144231237,3,0,start0,aligned
34,study7Line,16.0,78,38,2798,44,stackbar,set1,-6,6,False,2.6147098441152083,6,2,non-aligned,non-aligned
34,study7Line,10.0,79,50,2799,50,stackbar,set2,0,0,True,-3.0,0,4,non-aligned,non-aligned
28,study7Line,15.0,0,38,2240,40,stackbar,set3,-2,2,False,1.0874628412503393,10,2,non-aligned,non-aligned
28,study7Line,12.0,1,46,2241,47,stackbar,set2,-1,1,False,0.16992500144231237,3,0,start0,aligned
28,study7Line,11.0,2,11,2242,12,stackbar,set2,-1,1,False,0.16992500144231237,12,0,start0,aligned
28,study7Line,12.0,3,45,2243,46,stackbar,set4,-1,1,False,0.16992500144231237,4,2,non-aligned,non-aligned
28,study7Line,22.0,4,30,2244,31,stackbar,set3,-1,1,False,0.16992500144231237,6,0,start0,aligned
28,study7Line,14.0,5,26,2245,26,stackbar,set1,0,0,True,-3.0,1,0,start0,aligned
28,study7Line,7.0,6,31,2246,32,stackbar,set4,-1,1,False,0.16992500144231237,7,0,start0,aligned
28,study7Line,6.0,7,20,2247,19,stackbar,set3,1,1,False,0.16992500144231237,6,0,start0,aligned
28,study7Line,11.0,8,49,2248,49,stackbar,set3,0,0,True,-3.0,1,1,non-aligned,non-aligned
28,study7Line,9.0,9,11,2249,13,stackbar,set2,-2,2,False,1.0874628412503393,12,6,non-aligned,non-aligned
28,study7Line,22.0,10,46,2250,43,stackbar,set2,3,3,False,1.6438561897747246,7,2,non-aligned,non-aligned
28,study7Line,7.0,11,33,2251,33,stackbar,set3,0,0,True,-3.0,8,0,start0,aligned
28,study7Line,42.0,12,34,2252,20,stackbar,set4,14,14,False,3.820178962415188,5,5,non-aligned,non-aligned
28,study7Line,38.0,13,19,2253,22,stackbar,set3,-3,3,False,1.6438561897747246,3,0,start0,aligned
28,study7Line,12.0,14,19,2254,21,stackbar,set4,-2,2,False,1.0874628412503393,4,2,non-aligned,non-aligned
28,study7Line,15.0,15,13,2255,15,stackbar,set1,-2,2,False,1.0874628412503393,10,0,start0,aligned
28,study7Line,6.0,16,46,2256,46,stackbar,set4,0,0,True,-3.0,4,0,start0,aligned
28,study7Line,18.0,17,10,2257,12,stackbar,set3,-2,2,False,1.0874628412503393,12,1,non-aligned,non-aligned
28,study7Line,17.0,18,37,2258,41,stackbar,set4,-4,4,False,2.0443941193584534,9,0,start0,aligned
28,study7Line,20.0,19,22,2259,25,stackbar,set3,-3,3,False,1.6438561897747246,0,5,non-aligned,non-aligned
28,study7Line,16.0,20,18,2260,20,stackbar,set3,-2,2,False,1.0874628412503393,5,0,start0,aligned
28,study7Line,13.0,21,32,2261,35,stackbar,set2,-3,3,False,1.6438561897747246,10,3,non-aligned,non-aligned
28,study7Line,33.0,22,41,2262,45,stackbar,set1,-4,4,False,2.0443941193584534,5,0,start0,aligned
28,study7Line,22.0,23,28,2263,32,stackbar,set4,-4,4,False,2.0443941193584534,7,7,non-aligned,non-aligned
28,study7Line,50.0,24,28,2264,27,stackbar,set3,1,1,False,0.16992500144231237,2,0,start0,aligned
28,study7Line,13.0,25,50,2265,50,stackbar,set3,0,0,True,-3.0,0,5,non-aligned,non-aligned
28,study7Line,5.0,26,25,2266,25,stackbar,set1,0,0,True,-3.0,0,0,start0,aligned
28,study7Line,15.0,27,36,2267,36,stackbar,set1,0,0,True,-3.0,11,3,non-aligned,non-aligned
28,study7Line,15.0,28,34,2268,34,stackbar,set1,0,0,True,-3.0,9,0,start0,aligned
28,study7Line,35.0,29,49,2269,49,stackbar,set1,0,0,True,-3.0,1,0,start0,aligned
28,study7Line,12.0,30,34,2270,34,stackbar,set3,0,0,True,-3.0,9,3,non-aligned,non-aligned
28,study7Line,16.0,31,42,2271,42,stackbar,set3,0,0,True,-3.0,8,0,start0,aligned
28,study7Line,18.0,32,22,2272,22,stackbar,set1,0,0,True,-3.0,3,2,non-aligned,non-aligned
28,study7Line,18.0,33,48,2273,48,stackbar,set2,0,0,True,-3.0,2,2,non-aligned,non-aligned
28,study7Line,15.0,34,27,2274,27,stackbar,set2,0,0,True,-3.0,2,11,non-aligned,non-aligned
28,study7Line,14.0,35,23,2275,23,stackbar,set1,0,0,True,-3.0,2,0,start0,aligned
28,study7Line,65.0,36,31,2276,31,stackbar,set4,0,0,True,-3.0,6,0,end50,aligned
28,study7Line,16.0,37,37,2277,37,stackbar,set3,0,0,True,-3.0,12,0,start25,aligned
28,study7Line,13.0,38,14,2278,14,stackbar,set1,0,0,True,-3.0,11,0,start0,aligned
28,study7Line,17.0,39,29,2279,29,stackbar,set4,0,0,True,-3.0,4,3,non-aligned,non-aligned
28,study7Line,33.0,40,33,2280,33,stackbar,set2,0,0,True,-3.0,8,8,non-aligned,non-aligned
28,study7Line,15.0,41,30,2281,30,stackbar,set2,0,0,True,-3.0,5,0,start0,aligned
28,study7Line,15.0,42,14,2282,14,stackbar,set3,0,0,True,-3.0,11,2,non-aligned,non-aligned
28,study7Line,14.0,43,18,2283,18,stackbar,set3,0,0,True,-3.0,7,2,non-aligned,non-aligned
28,study7Line,24.0,44,24,2284,24,stackbar,set2,0,0,True,-3.0,1,0,start0,aligned
28,study7Line,14.0,45,45,2285,45,stackbar,set2,0,0,True,-3.0,5,9,non-aligned,non-aligned
28,study7Line,17.0,46,48,2286,47,stackbar,set2,1,1,False,0.16992500144231237,3,2,non-aligned,non-aligned
28,study7Line,72.0,47,39,2287,39,stackbar,set4,0,0,True,-3.0,11,0,start0,aligned
28,study7Line,14.0,48,13,2288,13,stackbar,set1,0,0,True,-3.0,12,0,start0,aligned
28,study7Line,15.0,49,17,2289,17,stackbar,set2,0,0,True,-3.0,8,5,non-aligned,non-aligned
28,study7Line,12.0,50,19,2290,19,stackbar,set1,0,0,True,-3.0,6,8,non-aligned,non-aligned
28,study7Line,6.0,51,50,2291,50,stackbar,set1,0,0,True,-3.0,0,0,start0,aligned
28,study7Line,14.0,52,37,2292,37,stackbar,set4,0,0,True,-3.0,12,0,start0,aligned
28,study7Line,6.0,53,48,2293,48,stackbar,set4,0,0,True,-3.0,2,0,start0,aligned
28,study7Line,16.0,54,11,2294,11,stackbar,set4,0,0,True,-3.0,11,0,start0,aligned
28,study7Line,18.0,55,44,2295,44,stackbar,set4,0,0,True,-3.0,6,2,non-aligned,non-aligned
28,study7Line,14.0,56,26,2296,26,stackbar,set4,0,0,True,-3.0,1,1,non-aligned,non-aligned
28,study7Line,13.0,57,36,2297,36,stackbar,set3,0,0,True,-3.0,11,0,start0,aligned
28,study7Line,7.0,58,29,2298,29,stackbar,set2,0,0,True,-3.0,4,0,start0,aligned
28,study7Line,11.0,59,44,2299,44,stackbar,set1,0,0,True,-3.0,6,0,start0,aligned
28,study7Line,15.0,60,23,2300,23,stackbar,set2,0,0,True,-3.0,2,5,non-aligned,non-aligned
28,study7Line,85.0,61,41,2301,40,stackbar,set1,1,1,False,0.16992500144231237,10,0,start0,aligned
28,study7Line,15.0,62,24,2302,24,stackbar,set2,0,0,True,-3.0,1,2,non-aligned,non-aligned
28,study7Line,16.0,63,30,2303,30,stackbar,set2,0,0,True,-3.0,5,4,non-aligned,non-aligned
28,study7Line,40.0,64,39,2304,39,stackbar,set4,0,0,True,-3.0,11,1,non-aligned,non-aligned
28,study7Line,16.0,65,38,2305,38,stackbar,set3,0,0,True,-3.0,12,0,start0,aligned
28,study7Line,6.0,66,21,2306,21,stackbar,set4,0,0,True,-3.0,4,0,start0,aligned
28,study7Line,15.0,67,16,2307,16,stackbar,set1,0,0,True,-3.0,9,0,start0,aligned
28,study7Line,20.0,68,28,2308,28,stackbar,set3,0,0,True,-3.0,3,9,non-aligned,non-aligned
28,study7Line,14.0,69,11,2309,11,stackbar,set2,0,0,True,-3.0,11,2,non-aligned,non-aligned
28,study7Line,13.0,70,43,2310,43,stackbar,set2,0,0,True,-3.0,7,0,start0,aligned
28,study7Line,13.0,71,35,2311,35,stackbar,set3,0,0,True,-3.0,10,0,start0,aligned
28,study7Line,13.0,72,38,2312,38,stackbar,set2,0,0,True,-3.0,12,5,non-aligned,non-aligned
28,study7Line,14.0,73,17,2313,17,stackbar,set4,0,0,True,-3.0,8,0,start0,aligned
28,study7Line,13.0,74,16,2314,16,stackbar,set3,0,0,True,-3.0,9,3,non-aligned,non-aligned
28,study7Line,16.0,75,14,2315,15,stackbar,set3,-1,1,False,0.16992500144231237,10,3,non-aligned,non-aligned
28,study7Line,13.0,76,18,2316,18,stackbar,set3,0,0,True,-3.0,7,0,start0,aligned
28,study7Line,6.0,77,28,2317,28,stackbar,set3,0,0,True,-3.0,3,0,start0,aligned
28,study7Line,14.0,78,41,2318,41,stackbar,set2,0,0,True,-3.0,9,4,non-aligned,non-aligned
28,study7Line,13.0,79,42,2319,42,stackbar,set3,0,0,True,-3.0,8,7,non-aligned,non-aligned
19,study7Line,17.0,0,50,1520,28,stackbar,set1,22,22,False,4.467605550082998,3,10,non-aligned,non-aligned
19,study7Line,14.0,1,25,1521,25,stackbar,set1,0,0,True,-3.0,0,0,start0,aligned
19,study7Line,27.0,2,35,1522,41,stackbar,set1,-6,6,False,2.6147098441152083,9,6,non-aligned,non-aligned
19,study7Line,25.0,3,40,1523,36,stackbar,set1,4,4,False,2.0443941193584534,11,0,start0,aligned
19,study7Line,6.0,4,40,1524,40,stackbar,set1,0,0,True,-3.0,10,0,start0,aligned
19,study7Line,22.0,5,10,1525,13,stackbar,set3,-3,3,False,1.6438561897747246,12,2,non-aligned,non-aligned
19,study7Line,6.0,6,24,1526,24,stackbar,set3,0,0,True,-3.0,1,0,start0,aligned
19,study7Line,6.0,7,25,1527,37,stackbar,set2,-12,12,False,3.599912842187128,12,5,non-aligned,non-aligned
19,study7Line,10.0,8,30,1528,39,stackbar,set3,-9,9,False,3.189824558880017,11,3,non-aligned,non-aligned
19,study7Line,13.0,9,48,1529,47,stackbar,set1,1,1,False,0.16992500144231237,3,0,start0,aligned
19,study7Line,6.0,10,24,1530,22,stackbar,set4,2,2,False,1.0874628412503393,3,0,start0,aligned
19,study7Line,24.0,11,49,1531,49,stackbar,set2,0,0,True,-3.0,1,0,start0,aligned
19,study7Line,8.0,12,30,1532,35,stackbar,set2,-5,5,False,2.357552004618084,10,0,start0,aligned
19,study7Line,14.0,13,40,1533,40,stackbar,set3,0,0,True,-3.0,10,2,non-aligned,non-aligned
19,study7Line,5.0,14,48,1534,48,stackbar,set2,0,0,True,-3.0,2,0,start0,aligned
19,study7Line,8.0,15,20,1535,17,stackbar,set2,3,3,False,1.6438561897747246,8,5,non-aligned,non-aligned
19,study7Line,8.0,16,20,1536,19,stackbar,set1,1,1,False,0.16992500144231237,6,8,non-aligned,non-aligned
19,study7Line,7.0,17,10,1537,13,stackbar,set1,-3,3,False,1.6438561897747246,12,0,start0,aligned
19,study7Line,5.0,18,10,1538,12,stackbar,set2,-2,2,False,1.0874628412503393,12,1,non-aligned,non-aligned
19,study7Line,6.0,19,25,1539,38,stackbar,set4,-13,13,False,3.7142455176661224,12,6,non-aligned,non-aligned
19,study7Line,8.0,20,30,1540,32,stackbar,set2,-2,2,False,1.0874628412503393,7,0,start0,aligned
19,study7Line,9.0,21,30,1541,38,stackbar,set4,-8,8,False,3.0223678130284544,12,0,start0,aligned
19,study7Line,6.0,22,25,1542,30,stackbar,set1,-5,5,False,2.357552004618084,5,8,non-aligned,non-aligned
19,study7Line,4.0,23,10,1543,12,stackbar,set1,-2,2,False,1.0874628412503393,12,0,start0,aligned
19,study7Line,7.0,24,40,1544,43,stackbar,set3,-3,3,False,1.6438561897747246,7,0,start0,aligned
19,study7Line,6.0,25,25,1545,25,stackbar,set4,0,0,True,-3.0,0,0,start25,aligned
19,study7Line,4.0,26,10,1546,16,stackbar,set2,-6,6,False,2.6147098441152083,9,0,start0,aligned
19,study7Line,8.0,27,30,1547,26,stackbar,set3,4,4,False,2.0443941193584534,1,3,non-aligned,non-aligned
19,study7Line,4.0,28,15,1548,14,stackbar,set2,1,1,False,0.16992500144231237,11,0,start0,aligned
19,study7Line,43.0,29,50,1549,48,stackbar,set3,2,2,False,1.0874628412503393,2,2,non-aligned,non-aligned
19,study7Line,7.0,30,30,1550,29,stackbar,set2,1,1,False,0.16992500144231237,4,2,non-aligned,non-aligned
19,study7Line,5.0,31,20,1551,21,stackbar,set1,-1,1,False,0.16992500144231237,4,0,start0,aligned
19,study7Line,5.0,32,20,1552,19,stackbar,set3,1,1,False,0.16992500144231237,6,0,start0,aligned
19,study7Line,7.0,33,30,1553,30,stackbar,set1,0,0,True,-3.0,5,0,start0,aligned
19,study7Line,5.0,34,24,1554,23,stackbar,set1,1,1,False,0.16992500144231237,2,0,start0,aligned
19,study7Line,6.0,35,35,1555,34,stackbar,set4,1,1,False,0.16992500144231237,9,0,start0,aligned
19,study7Line,8.0,36,40,1556,44,stackbar,set4,-4,4,False,2.0443941193584534,6,2,non-aligned,non-aligned
19,study7Line,23.0,37,20,1557,20,stackbar,set1,0,0,True,-3.0,5,0,start75,aligned
19,study7Line,6.0,38,40,1558,39,stackbar,set3,1,1,False,0.16992500144231237,11,0,start0,aligned
19,study7Line,39.0,39,26,1559,26,stackbar,set4,0,0,True,-3.0,1,0,start0,aligned
19,study7Line,5.0,40,50,1560,42,stackbar,set3,8,8,False,3.0223678130284544,8,7,non-aligned,non-aligned
19,study7Line,5.0,41,45,1561,45,stackbar,set4,0,0,True,-3.0,5,0,start0,aligned
19,study7Line,5.0,42,25,1562,24,stackbar,set4,1,1,False,0.16992500144231237,1,9,non-aligned,non-aligned
19,study7Line,5.0,43,30,1563,37,stackbar,set3,-7,7,False,2.8328900141647417,12,0,start0,aligned
19,study7Line,3.0,44,25,1564,16,stackbar,set1,9,9,False,3.189824558880017,9,1,non-aligned,non-aligned
19,study7Line,4.0,45,20,1565,18,stackbar,set4,2,2,False,1.0874628412503393,7,3,non-aligned,non-aligned
19,study7Line,5.0,46,35,1566,32,stackbar,set1,3,3,False,1.6438561897747246,7,2,non-aligned,non-aligned
19,study7Line,9.0,47,28,1567,29,stackbar,set3,-1,1,False,0.16992500144231237,4,0,start0,aligned
19,study7Line,5.0,48,28,1568,28,stackbar,set3,0,0,True,-3.0,3,0,start0,aligned
19,study7Line,5.0,49,45,1569,36,stackbar,set1,9,9,False,3.189824558880017,11,3,non-aligned,non-aligned
19,study7Line,4.0,50,15,1570,17,stackbar,set2,-2,2,False,1.0874628412503393,8,0,start0,aligned
19,study7Line,5.0,51,40,1571,44,stackbar,set1,-4,4,False,2.0443941193584534,6,0,start0,aligned
19,study7Line,5.0,52,25,1572,22,stackbar,set3,3,3,False,1.6438561897747246,3,2,non-aligned,non-aligned
19,study7Line,5.0,53,45,1573,33,stackbar,set2,12,12,False,3.599912842187128,8,8,non-aligned,non-aligned
19,study7Line,4.0,54,20,1574,20,stackbar,set4,0,0,True,-3.0,5,0,start0,aligned
19,study7Line,5.0,55,10,1575,14,stackbar,set4,-4,4,False,2.0443941193584534,11,6,non-aligned,non-aligned
19,study7Line,3.0,56,45,1576,46,stackbar,set3,-1,1,False,0.16992500144231237,4,0,start0,aligned
19,study7Line,5.0,57,10,1577,11,stackbar,set1,-1,1,False,0.16992500144231237,11,4,non-aligned,non-aligned
19,study7Line,7.0,58,48,1578,49,stackbar,set3,-1,1,False,0.16992500144231237,1,1,non-aligned,non-aligned
19,study7Line,28.0,59,15,1579,15,stackbar,set3,0,0,True,-3.0,10,3,non-aligned,non-aligned
19,study7Line,4.0,60,25,1580,23,stackbar,set2,2,2,False,1.0874628412503393,2,5,non-aligned,non-aligned
19,study7Line,5.0,61,30,1581,27,stackbar,set3,3,3,False,1.6438561897747246,2,6,non-aligned,non-aligned
19,study7Line,4.0,62,15,1582,18,stackbar,set1,-3,3,False,1.6438561897747246,7,0,start0,aligned
19,study7Line,5.0,63,30,1583,31,stackbar,set1,-1,1,False,0.16992500144231237,6,4,non-aligned,non-aligned
19,study7Line,5.0,64,40,1584,35,stackbar,set3,5,5,False,2.357552004618084,10,2,non-aligned,non-aligned
19,study7Line,6.0,65,40,1585,42,stackbar,set2,-2,2,False,1.0874628412503393,8,0,start0,aligned
19,study7Line,3.0,66,50,1586,50,stackbar,set1,0,0,True,-3.0,0,0,start0,aligned
19,study7Line,4.0,67,30,1587,31,stackbar,set3,-1,1,False,0.16992500144231237,6,0,start0,aligned
19,study7Line,5.0,68,23,1588,21,stackbar,set3,2,2,False,1.0874628412503393,4,2,non-aligned,non-aligned
19,study7Line,33.0,69,27,1589,27,stackbar,set1,0,0,True,-3.0,2,0,start0,aligned
19,study7Line,5.0,70,35,1590,34,stackbar,set2,1,1,False,0.16992500144231237,9,2,non-aligned,non-aligned
19,study7Line,4.0,71,40,1591,41,stackbar,set3,-1,1,False,0.16992500144231237,9,0,start0,aligned
19,study7Line,5.0,72,50,1592,50,stackbar,set1,0,0,True,-3.0,0,6,non-aligned,non-aligned
19,study7Line,5.0,73,45,1593,47,stackbar,set1,-2,2,False,1.0874628412503393,3,2,non-aligned,non-aligned
19,study7Line,8.0,74,50,1594,46,stackbar,set3,4,4,False,2.0443941193584534,4,10,non-aligned,non-aligned
19,study7Line,4.0,75,40,1595,45,stackbar,set2,-5,5,False,2.357552004618084,5,9,non-aligned,non-aligned
19,study7Line,4.0,76,10,1596,11,stackbar,set1,-1,1,False,0.16992500144231237,11,0,start0,aligned
19,study7Line,4.0,77,40,1597,43,stackbar,set4,-3,3,False,1.6438561897747246,7,6,non-aligned,non-aligned
19,study7Line,4.0,78,30,1598,33,stackbar,set2,-3,3,False,1.6438561897747246,8,0,start0,aligned
19,study7Line,4.0,79,15,1599,15,stackbar,set1,0,0,True,-3.0,10,0,start0,aligned
4,study7Line,15.0,0,30,320,31,stackbar,set3,-1,1,False,0.16992500144231237,6,2,non-aligned,non-aligned
4,study7Line,11.0,1,45,321,45,stackbar,set1,0,0,True,-3.0,5,0,start0,aligned
4,study7Line,12.0,2,35,322,32,stackbar,set4,3,3,False,1.6438561897747246,7,0,start0,aligned
4,study7Line,12.0,3,35,323,35,stackbar,set3,0,0,True,-3.0,10,0,start0,aligned
4,study7Line,9.0,4,20,324,15,stackbar,set2,5,5,False,2.357552004618084,10,4,non-aligned,non-aligned
4,study7Line,6.0,5,27,325,28,stackbar,set2,-1,1,False,0.16992500144231237,3,0,start0,aligned
4,study7Line,5.0,6,48,326,48,stackbar,set1,0,0,True,-3.0,2,0,start0,aligned
4,study7Line,8.0,7,50,327,42,stackbar,set3,8,8,False,3.0223678130284544,8,7,non-aligned,non-aligned
4,study7Line,8.0,8,18,328,16,stackbar,set1,2,2,False,1.0874628412503393,9,0,start0,aligned
4,study7Line,5.0,9,22,329,22,stackbar,set2,0,0,True,-3.0,3,0,start0,aligned
4,study7Line,8.0,10,50,330,50,stackbar,set2,0,0,True,-3.0,0,4,non-aligned,non-aligned
4,study7Line,12.0,11,40,331,39,stackbar,set4,1,1,False,0.16992500144231237,11,1,non-aligned,non-aligned
4,study7Line,9.0,12,16,332,21,stackbar,set1,-5,5,False,2.357552004618084,4,1,non-aligned,non-aligned
4,study7Line,5.0,13,25,333,26,stackbar,set1,-1,1,False,0.16992500144231237,1,3,non-aligned,non-aligned
4,study7Line,6.0,14,50,334,45,stackbar,set2,5,5,False,2.357552004618084,5,9,non-aligned,non-aligned
4,study7Line,8.0,15,12,335,11,stackbar,set2,1,1,False,0.16992500144231237,11,2,non-aligned,non-aligned
4,study7Line,12.0,16,40,336,43,stackbar,set1,-3,3,False,1.6438561897747246,7,2,non-aligned,non-aligned
4,study7Line,9.0,17,22,337,23,stackbar,set4,-1,1,False,0.16992500144231237,2,10,non-aligned,non-aligned
4,study7Line,7.0,18,30,338,31,stackbar,set2,-1,1,False,0.16992500144231237,6,0,start0,aligned
4,study7Line,9.0,19,13,339,15,stackbar,set4,-2,2,False,1.0874628412503393,10,0,start0,aligned
4,study7Line,4.0,20,27,340,29,stackbar,set1,-2,2,False,1.0874628412503393,4,0,start0,aligned
4,study7Line,15.0,21,40,341,40,stackbar,set1,0,0,True,-3.0,10,6,non-aligned,non-aligned
4,study7Line,7.0,22,12,342,13,stackbar,set3,-1,1,False,0.16992500144231237,12,2,non-aligned,non-aligned
4,study7Line,7.0,23,23,343,22,stackbar,set4,1,1,False,0.16992500144231237,3,0,start75,aligned
4,study7Line,5.0,24,32,344,33,stackbar,set2,-1,1,False,0.16992500144231237,8,0,start0,aligned
4,study7Line,8.0,25,25,345,25,stackbar,set1,0,0,True,-3.0,0,0,start0,aligned
4,study7Line,6.0,26,18,346,18,stackbar,set3,0,0,True,-3.0,7,0,start0,aligned
4,study7Line,7.0,27,27,347,30,stackbar,set2,-3,3,False,1.6438561897747246,5,4,non-aligned,non-aligned
4,study7Line,5.0,28,26,348,28,stackbar,set3,-2,2,False,1.0874628412503393,3,9,non-aligned,non-aligned
4,study7Line,7.0,29,48,349,47,stackbar,set3,1,1,False,0.16992500144231237,3,0,start0,aligned
4,study7Line,7.0,30,20,350,19,stackbar,set3,1,1,False,0.16992500144231237,6,1,non-aligned,non-aligned
4,study7Line,7.0,31,18,351,20,stackbar,set1,-2,2,False,1.0874628412503393,5,0,start75,aligned
4,study7Line,8.0,32,35,352,37,stackbar,set4,-2,2,False,1.0874628412503393,12,1,non-aligned,non-aligned
4,study7Line,7.0,33,52,353,46,stackbar,set2,6,6,False,2.6147098441152083,4,9,non-aligned,non-aligned
4,study7Line,6.0,34,49,354,49,stackbar,set4,0,0,True,-3.0,1,0,start0,aligned
4,study7Line,12.0,35,31,355,33,stackbar,set3,-2,2,False,1.0874628412503393,8,3,non-aligned,non-aligned
4,study7Line,11.0,36,38,356,38,stackbar,set1,0,0,True,-3.0,12,1,non-aligned,non-aligned
4,study7Line,5.0,37,20,357,17,stackbar,set3,3,3,False,1.6438561897747246,8,0,start0,aligned
4,study7Line,13.0,38,32,358,39,stackbar,set2,-7,7,False,2.8328900141647417,11,0,start0,aligned
4,study7Line,8.0,39,12,359,12,stackbar,set3,0,0,True,-3.0,12,0,start0,aligned
4,study7Line,10.0,40,48,360,48,stackbar,set2,0,0,True,-3.0,2,2,non-aligned,non-aligned
4,study7Line,8.0,41,30,361,35,stackbar,set4,-5,5,False,2.357552004618084,10,0,end100,aligned
4,study7Line,6.0,42,46,362,44,stackbar,set2,2,2,False,1.0874628412503393,6,0,start0,aligned
4,study7Line,6.0,43,35,363,40,stackbar,set4,-5,5,False,2.357552004618084,10,0,start0,aligned
4,study7Line,9.0,44,25,364,25,stackbar,set2,0,0,True,-3.0,0,8,non-aligned,non-aligned
4,study7Line,8.0,45,27,365,27,stackbar,set2,0,0,True,-3.0,2,0,start0,aligned
4,study7Line,10.0,46,29,366,29,stackbar,set1,0,0,True,-3.0,4,2,non-aligned,non-aligned
4,study7Line,8.0,47,35,367,41,stackbar,set2,-6,6,False,2.6147098441152083,9,0,start0,aligned
4,study7Line,5.0,48,20,368,21,stackbar,set4,-1,1,False,0.16992500144231237,4,0,start0,aligned
4,study7Line,8.0,49,18,369,17,stackbar,set1,1,1,False,0.16992500144231237,8,0,start25,aligned
4,study7Line,17.0,50,34,370,34,stackbar,set4,0,0,True,-3.0,9,2,non-aligned,non-aligned
4,study7Line,6.0,51,20,371,18,stackbar,set4,2,2,False,1.0874628412503393,7,3,non-aligned,non-aligned
4,study7Line,7.0,52,48,372,49,stackbar,set1,-1,1,False,0.16992500144231237,1,8,non-aligned,non-aligned
4,study7Line,7.0,53,32,373,32,stackbar,set3,0,0,True,-3.0,7,2,non-aligned,non-aligned
4,study7Line,4.0,54,46,374,46,stackbar,set1,0,0,True,-3.0,4,0,start0,aligned
4,study7Line,6.0,55,25,375,24,stackbar,set1,1,1,False,0.16992500144231237,1,5,non-aligned,non-aligned
4,study7Line,7.0,56,32,376,36,stackbar,set4,-4,4,False,2.0443941193584534,11,0,start0,aligned
4,study7Line,11.0,57,34,377,37,stackbar,set4,-3,3,False,1.6438561897747246,12,0,start0,aligned
4,study7Line,7.0,58,26,378,27,stackbar,set4,-1,1,False,0.16992500144231237,2,3,non-aligned,non-aligned
4,study7Line,7.0,59,13,379,14,stackbar,set2,-1,1,False,0.16992500144231237,11,0,start0,aligned
4,study7Line,5.0,60,24,380,23,stackbar,set3,1,1,False,0.16992500144231237,2,0,start0,aligned
4,study7Line,8.0,61,32,381,38,stackbar,set1,-6,6,False,2.6147098441152083,12,0,start0,aligned
4,study7Line,4.0,62,24,382,24,stackbar,set4,0,0,True,-3.0,1,0,start0,aligned
4,study7Line,9.0,63,38,383,42,stackbar,set4,-4,4,False,2.0443941193584534,8,0,start0,aligned
4,study7Line,5.0,64,30,384,30,stackbar,set1,0,0,True,-3.0,5,0,start0,aligned
4,study7Line,11.0,65,36,385,41,stackbar,set3,-5,5,False,2.357552004618084,9,1,non-aligned,non-aligned
4,study7Line,10.0,66,48,386,44,stackbar,set3,4,4,False,2.0443941193584534,6,8,non-aligned,non-aligned
4,study7Line,8.0,67,32,387,34,stackbar,set4,-2,2,False,1.0874628412503393,9,0,start0,aligned
4,study7Line,6.0,68,50,388,50,stackbar,set2,0,0,True,-3.0,0,0,start0,aligned
4,study7Line,7.0,69,26,389,26,stackbar,set3,0,0,True,-3.0,1,0,start0,aligned
4,study7Line,12.0,70,11,390,11,stackbar,set2,0,0,True,-3.0,11,0,start0,aligned
4,study7Line,9.0,71,33,391,36,stackbar,set1,-3,3,False,1.6438561897747246,11,3,non-aligned,non-aligned
4,study7Line,5.0,72,20,392,20,stackbar,set2,0,0,True,-3.0,5,0,start0,aligned
4,study7Line,4.0,73,18,393,19,stackbar,set3,-1,1,False,0.16992500144231237,6,0,start0,aligned
4,study7Line,7.0,74,15,394,14,stackbar,set4,1,1,False,0.16992500144231237,11,6,non-aligned,non-aligned
4,study7Line,6.0,75,42,395,43,stackbar,set2,-1,1,False,0.16992500144231237,7,0,start0,aligned
4,study7Line,7.0,76,18,396,16,stackbar,set1,2,2,False,1.0874628412503393,9,1,non-aligned,non-aligned
4,study7Line,7.0,77,12,397,12,stackbar,set2,0,0,True,-3.0,12,1,non-aligned,non-aligned
4,study7Line,11.0,78,48,398,47,stackbar,set1,1,1,False,0.16992500144231237,3,2,non-aligned,non-aligned
4,study7Line,7.0,79,12,399,13,stackbar,set3,-1,1,False,0.16992500144231237,12,0,start0,aligned
37,study7Line,17.0,0,37,2960,37,stackbar,set2,0,0,True,-3.0,12,0,start0,aligned
37,study7Line,15.0,1,32,2961,35,stackbar,set2,-3,3,False,1.6438561897747246,10,0,start0,aligned
37,study7Line,6.0,2,25,2962,25,stackbar,set1,0,0,True,-3.0,0,0,start0,aligned
37,study7Line,10.0,3,40,2963,40,stackbar,set3,0,0,True,-3.0,10,0,start0,aligned
37,study7Line,5.0,4,49,2964,49,stackbar,set1,0,0,True,-3.0,1,0,start0,aligned
37,study7Line,8.0,5,30,2965,34,stackbar,set1,-4,4,False,2.0443941193584534,9,0,start0,aligned
37,study7Line,5.0,6,28,2966,29,stackbar,set4,-1,1,False,0.16992500144231237,4,0,start0,aligned
37,study7Line,10.0,7,39,2967,38,stackbar,set1,1,1,False,0.16992500144231237,12,1,non-aligned,non-aligned
37,study7Line,19.0,8,45,2968,43,stackbar,set1,2,2,False,1.0874628412503393,7,2,non-aligned,non-aligned
37,study7Line,5.0,9,26,2969,26,stackbar,set4,0,0,True,-3.0,1,0,start0,aligned
37,study7Line,11.0,10,40,2970,34,stackbar,set2,6,6,False,2.6147098441152083,9,2,non-aligned,non-aligned
37,study7Line,14.0,11,50,2971,50,stackbar,set1,0,0,True,-3.0,0,6,non-aligned,non-aligned
37,study7Line,12.0,12,45,2972,46,stackbar,set1,-1,1,False,0.16992500144231237,4,6,non-aligned,non-aligned
37,study7Line,9.0,13,35,2973,32,stackbar,set4,3,3,False,1.6438561897747246,7,7,non-aligned,non-aligned
37,study7Line,8.0,14,29,2974,30,stackbar,set1,-1,1,False,0.16992500144231237,5,0,start0,aligned
37,study7Line,6.0,15,48,2975,48,stackbar,set4,0,0,True,-3.0,2,0,start0,aligned
37,study7Line,10.0,16,18,2976,15,stackbar,set3,3,3,False,1.6438561897747246,10,3,non-aligned,non-aligned
37,study7Line,14.0,17,50,2977,48,stackbar,set1,2,2,False,1.0874628412503393,2,9,non-aligned,non-aligned
37,study7Line,6.0,18,40,2978,39,stackbar,set2,1,1,False,0.16992500144231237,11,0,start0,aligned
37,study7Line,10.0,19,20,2979,18,stackbar,set4,2,2,False,1.0874628412503393,7,3,non-aligned,non-aligned
37,study7Line,11.0,20,40,2980,42,stackbar,set2,-2,2,False,1.0874628412503393,8,0,start0,aligned
37,study7Line,6.0,21,27,2981,27,stackbar,set3,0,0,True,-3.0,2,0,start0,aligned
37,study7Line,8.0,22,35,2982,33,stackbar,set3,2,2,False,1.0874628412503393,8,3,non-aligned,non-aligned
37,study7Line,8.0,23,25,2983,24,stackbar,set1,1,1,False,0.16992500144231237,1,5,non-aligned,non-aligned
37,study7Line,10.0,24,16,2984,13,stackbar,set4,3,3,False,1.6438561897747246,12,6,non-aligned,non-aligned
37,study7Line,9.0,25,46,2985,44,stackbar,set4,2,2,False,1.0874628412503393,6,2,non-aligned,non-aligned
37,study7Line,7.0,26,28,2986,29,stackbar,set1,-1,1,False,0.16992500144231237,4,2,non-aligned,non-aligned
37,study7Line,16.0,27,39,2987,39,stackbar,set4,0,0,True,-3.0,11,1,non-aligned,non-aligned
37,study7Line,5.0,28,48,2988,47,stackbar,set4,1,1,False,0.16992500144231237,3,0,start0,aligned
37,study7Line,7.0,29,27,2989,27,stackbar,set3,0,0,True,-3.0,2,6,non-aligned,non-aligned
37,study7Line,7.0,30,10,2990,12,stackbar,set2,-2,2,False,1.0874628412503393,12,0,start0,aligned
37,study7Line,10.0,31,40,2991,35,stackbar,set1,5,5,False,2.357552004618084,10,6,non-aligned,non-aligned
37,study7Line,15.0,32,38,2992,42,stackbar,set1,-4,4,False,2.0443941193584534,8,3,non-aligned,non-aligned
37,study7Line,10.0,33,20,2993,20,stackbar,set4,0,0,True,-3.0,5,5,non-aligned,non-aligned
37,study7Line,6.0,34,12,2994,13,stackbar,set4,-1,1,False,0.16992500144231237,12,0,start0,aligned
37,study7Line,8.0,35,40,2995,37,stackbar,set1,3,3,False,1.6438561897747246,12,6,non-aligned,non-aligned
37,study7Line,11.0,36,35,2996,36,stackbar,set3,-1,1,False,0.16992500144231237,11,3,non-aligned,non-aligned
37,study7Line,9.0,37,47,2997,45,stackbar,set3,2,2,False,1.0874628412503393,5,0,start0,aligned
37,study7Line,12.0,38,17,2998,16,stackbar,set1,1,1,False,0.16992500144231237,9,1,non-aligned,non-aligned
37,study7Line,10.0,39,40,2999,45,stackbar,set3,-5,5,False,2.357552004618084,5,7,non-aligned,non-aligned
37,study7Line,8.0,40,22,3000,20,stackbar,set2,2,2,False,1.0874628412503393,5,0,start0,aligned
37,study7Line,6.0,41,48,3001,47,stackbar,set1,1,1,False,0.16992500144231237,3,2,non-aligned,non-aligned
37,study7Line,5.0,42,24,3002,24,stackbar,set3,0,0,True,-3.0,1,0,start0,aligned
37,study7Line,10.0,43,12,3003,11,stackbar,set1,1,1,False,0.16992500144231237,11,4,non-aligned,non-aligned
37,study7Line,10.0,44,38,3004,40,stackbar,set2,-2,2,False,1.0874628412503393,10,1,non-aligned,non-aligned
37,study7Line,8.0,45,40,3005,43,stackbar,set4,-3,3,False,1.6438561897747246,7,0,start0,aligned
37,study7Line,7.0,46,22,3006,21,stackbar,set2,1,1,False,0.16992500144231237,4,6,non-aligned,non-aligned
37,study7Line,7.0,47,18,3007,17,stackbar,set3,1,1,False,0.16992500144231237,8,0,start0,aligned
37,study7Line,9.0,48,18,3008,16,stackbar,set2,2,2,False,1.0874628412503393,9,0,start0,aligned
37,study7Line,5.0,49,23,3009,23,stackbar,set1,0,0,True,-3.0,2,0,start0,aligned
37,study7Line,9.0,50,34,3010,36,stackbar,set2,-2,2,False,1.0874628412503393,11,0,start0,aligned
37,study7Line,10.0,51,20,3011,19,stackbar,set1,1,1,False,0.16992500144231237,6,8,non-aligned,non-aligned
37,study7Line,6.0,52,15,3012,15,stackbar,set1,0,0,True,-3.0,10,0,start0,aligned
37,study7Line,13.0,53,30,3013,28,stackbar,set3,2,2,False,1.0874628412503393,3,9,non-aligned,non-aligned
37,study7Line,8.0,54,44,3014,46,stackbar,set2,-2,2,False,1.0874628412503393,4,0,start0,aligned
37,study7Line,7.0,55,50,3015,49,stackbar,set4,1,1,False,0.16992500144231237,1,5,non-aligned,non-aligned
37,study7Line,8.0,56,12,3016,12,stackbar,set4,0,0,True,-3.0,12,6,non-aligned,non-aligned
37,study7Line,8.0,57,30,3017,31,stackbar,set3,-1,1,False,0.16992500144231237,6,2,non-aligned,non-aligned
37,study7Line,4.0,58,12,3018,14,stackbar,set2,-2,2,False,1.0874628412503393,11,0,start0,aligned
37,study7Line,9.0,59,20,3019,17,stackbar,set1,3,3,False,1.6438561897747246,8,0,start25,aligned
37,study7Line,7.0,60,20,3020,14,stackbar,set3,6,6,False,2.6147098441152083,11,2,non-aligned,non-aligned
37,study7Line,8.0,61,30,3021,26,stackbar,set1,4,4,False,2.0443941193584534,1,3,non-aligned,non-aligned
37,study7Line,5.0,62,40,3022,41,stackbar,set4,-1,1,False,0.16992500144231237,9,0,start0,aligned
37,study7Line,6.0,63,22,3023,21,stackbar,set4,1,1,False,0.16992500144231237,4,0,start0,aligned
37,study7Line,6.0,64,22,3024,23,stackbar,set1,-1,1,False,0.16992500144231237,2,3,non-aligned,non-aligned
37,study7Line,4.0,65,50,3025,50,stackbar,set3,0,0,True,-3.0,0,0,start0,aligned
37,study7Line,6.0,66,28,3026,28,stackbar,set1,0,0,True,-3.0,3,0,start0,aligned
37,study7Line,9.0,67,20,3027,22,stackbar,set2,-2,2,False,1.0874628412503393,3,9,non-aligned,non-aligned
37,study7Line,6.0,68,22,3028,22,stackbar,set1,0,0,True,-3.0,3,0,start0,aligned
37,study7Line,7.0,69,10,3029,11,stackbar,set3,-1,1,False,0.16992500144231237,11,0,start0,aligned
37,study7Line,7.0,70,44,3030,44,stackbar,set3,0,0,True,-3.0,6,0,start0,aligned
37,study7Line,10.0,71,18,3031,19,stackbar,set2,-1,1,False,0.16992500144231237,6,0,start0,aligned
37,study7Line,10.0,72,30,3032,30,stackbar,set1,0,0,True,-3.0,5,8,non-aligned,non-aligned
37,study7Line,7.0,73,25,3033,25,stackbar,set4,0,0,True,-3.0,0,0,start25,aligned
37,study7Line,11.0,74,30,3034,31,stackbar,set1,-1,1,False,0.16992500144231237,6,0,start0,aligned
37,study7Line,5.0,75,30,3035,33,stackbar,set4,-3,3,False,1.6438561897747246,8,0,start0,aligned
37,study7Line,5.0,76,30,3036,32,stackbar,set1,-2,2,False,1.0874628412503393,7,0,start0,aligned
37,study7Line,9.0,77,40,3037,41,stackbar,set4,-1,1,False,0.16992500144231237,9,4,non-aligned,non-aligned
37,study7Line,7.0,78,37,3038,38,stackbar,set1,-1,1,False,0.16992500144231237,12,0,start0,aligned
37,study7Line,10.0,79,18,3039,18,stackbar,set4,0,0,True,-3.0,7,0,start0,aligned
22,study7Line,33.0,0,30,1760,19,stackbar,set2,11,11,False,3.4757334309663976,6,2,non-aligned,non-aligned
22,study7Line,25.0,1,48,1761,45,stackbar,set3,3,3,False,1.6438561897747246,5,0,start0,aligned
22,study7Line,34.0,2,29,1762,29,stackbar,set4,0,0,True,-3.0,4,0,start0,aligned
22,study7Line,12.0,3,50,1763,47,stackbar,set3,3,3,False,1.6438561897747246,3,10,non-aligned,non-aligned
22,study7Line,157.0,4,38,1764,39,stackbar,set2,-1,1,False,0.16992500144231237,11,0,start0,aligned
22,study7Line,72.0,5,10,1765,12,stackbar,set3,-2,2,False,1.0874628412503393,12,1,non-aligned,non-aligned
22,study7Line,11.0,6,32,1766,32,stackbar,set2,0,0,True,-3.0,7,0,start0,aligned
22,study7Line,25.0,7,45,1767,49,stackbar,set2,-4,4,False,2.0443941193584534,1,8,non-aligned,non-aligned
22,study7Line,12.0,8,20,1768,21,stackbar,set1,-1,1,False,0.16992500144231237,4,1,non-aligned,non-aligned
22,study7Line,9.0,9,45,1769,47,stackbar,set4,-2,2,False,1.0874628412503393,3,0,start0,aligned
22,study7Line,11.0,10,18,1770,20,stackbar,set4,-2,2,False,1.0874628412503393,5,0,start0,aligned
22,study7Line,23.0,11,40,1771,42,stackbar,set2,-2,2,False,1.0874628412503393,8,0,start0,aligned
22,study7Line,11.0,12,30,1772,29,stackbar,set3,1,1,False,0.16992500144231237,4,9,non-aligned,non-aligned
22,study7Line,14.0,13,15,1773,16,stackbar,set1,-1,1,False,0.16992500144231237,9,0,start0,aligned
22,study7Line,11.0,14,26,1774,26,stackbar,set2,0,0,True,-3.0,1,10,non-aligned,non-aligned
22,study7Line,12.0,15,45,1775,46,stackbar,set2,-1,1,False,0.16992500144231237,4,0,start0,aligned
22,study7Line,14.0,16,50,1776,50,stackbar,set1,0,0,True,-3.0,0,6,non-aligned,non-aligned
22,study7Line,13.0,17,30,1777,33,stackbar,set2,-3,3,False,1.6438561897747246,8,8,non-aligned,non-aligned
22,study7Line,8.0,18,30,1778,31,stackbar,set3,-1,1,False,0.16992500144231237,6,2,non-aligned,non-aligned
22,study7Line,9.0,19,32,1779,33,stackbar,set1,-1,1,False,0.16992500144231237,8,0,start0,aligned
22,study7Line,12.0,20,36,1780,38,stackbar,set1,-2,2,False,1.0874628412503393,12,1,non-aligned,non-aligned
22,study7Line,8.0,21,15,1781,17,stackbar,set4,-2,2,False,1.0874628412503393,8,1,non-aligned,non-aligned
22,study7Line,7.0,22,36,1782,37,stackbar,set3,-1,1,False,0.16992500144231237,12,0,start0,aligned
22,study7Line,6.0,23,17,1783,14,stackbar,set2,3,3,False,1.6438561897747246,11,0,start0,aligned
22,study7Line,17.0,24,43,1784,43,stackbar,set2,0,0,True,-3.0,7,2,non-aligned,non-aligned
22,study7Line,14.0,25,13,1785,14,stackbar,set1,-1,1,False,0.16992500144231237,11,5,non-aligned,non-aligned
22,study7Line,8.0,26,35,1786,36,stackbar,set1,-1,1,False,0.16992500144231237,11,0,start0,aligned
22,study7Line,12.0,27,22,1787,22,stackbar,set4,0,0,True,-3.0,3,0,start75,aligned
22,study7Line,7.0,28,20,1788,22,stackbar,set1,-2,2,False,1.0874628412503393,3,0,start0,aligned
22,study7Line,6.0,29,50,1789,50,stackbar,set2,0,0,True,-3.0,0,0,start0,aligned
22,study7Line,4.0,30,15,1790,17,stackbar,set1,-2,2,False,1.0874628412503393,8,0,start0,aligned
22,study7Line,7.0,31,38,1791,40,stackbar,set3,-2,2,False,1.0874628412503393,10,0,start0,aligned
22,study7Line,7.0,32,35,1792,38,stackbar,set2,-3,3,False,1.6438561897747246,12,0,start0,aligned
22,study7Line,6.0,33,12,1793,13,stackbar,set4,-1,1,False,0.16992500144231237,12,6,non-aligned,non-aligned
22,study7Line,8.0,34,23,1794,23,stackbar,set4,0,0,True,-3.0,2,0,start0,aligned
22,study7Line,8.0,35,27,1795,28,stackbar,set3,-1,1,False,0.16992500144231237,3,0,start0,aligned
22,study7Line,21.0,36,32,1796,34,stackbar,set2,-2,2,False,1.0874628412503393,9,2,non-aligned,non-aligned
22,study7Line,9.0,37,30,1797,30,stackbar,set2,0,0,True,-3.0,5,0,start0,aligned
22,study7Line,27.0,38,34,1798,35,stackbar,set3,-1,1,False,0.16992500144231237,10,2,non-aligned,non-aligned
22,study7Line,8.0,39,36,1799,37,stackbar,set3,-1,1,False,0.16992500144231237,12,0,start25,aligned
22,study7Line,20.0,40,44,1800,44,stackbar,set3,0,0,True,-3.0,6,8,non-aligned,non-aligned
22,study7Line,7.0,41,48,1801,48,stackbar,set3,0,0,True,-3.0,2,0,start0,aligned
22,study7Line,6.0,42,16,1802,19,stackbar,set3,-3,3,False,1.6438561897747246,6,0,start0,aligned
22,study7Line,11.0,43,29,1803,28,stackbar,set4,1,1,False,0.16992500144231237,3,5,non-aligned,non-aligned
22,study7Line,13.0,44,35,1804,34,stackbar,set1,1,1,False,0.16992500144231237,9,0,start0,aligned
22,study7Line,11.0,45,14,1805,15,stackbar,set1,-1,1,False,0.16992500144231237,10,0,start0,aligned
22,study7Line,308.0,46,40,1806,41,stackbar,set4,-1,1,False,0.16992500144231237,9,4,non-aligned,non-aligned
22,study7Line,81.0,47,24,1807,24,stackbar,set4,0,0,True,-3.0,1,0,start0,aligned
22,study7Line,9.0,48,26,1808,26,stackbar,set4,0,0,True,-3.0,1,0,start0,aligned
22,study7Line,46.0,49,30,1809,30,stackbar,set4,0,0,True,-3.0,5,1,non-aligned,non-aligned
22,study7Line,11.0,50,40,1810,41,stackbar,set2,-1,1,False,0.16992500144231237,9,0,start0,aligned
22,study7Line,16.0,51,35,1811,36,stackbar,set4,-1,1,False,0.16992500144231237,11,3,non-aligned,non-aligned
22,study7Line,6.0,52,15,1812,16,stackbar,set2,-1,1,False,0.16992500144231237,9,2,non-aligned,non-aligned
22,study7Line,5.0,53,26,1813,27,stackbar,set2,-1,1,False,0.16992500144231237,2,0,start0,aligned
22,study7Line,9.0,54,45,1814,46,stackbar,set1,-1,1,False,0.16992500144231237,4,6,non-aligned,non-aligned
22,study7Line,25.0,55,26,1815,27,stackbar,set4,-1,1,False,0.16992500144231237,2,3,non-aligned,non-aligned
22,study7Line,5.0,56,25,1816,25,stackbar,set4,0,0,True,-3.0,0,0,start0,aligned
22,study7Line,9.0,57,40,1817,42,stackbar,set4,-2,2,False,1.0874628412503393,8,1,non-aligned,non-aligned
22,study7Line,15.0,58,17,1818,18,stackbar,set1,-1,1,False,0.16992500144231237,7,1,non-aligned,non-aligned
22,study7Line,5.0,59,30,1819,31,stackbar,set2,-1,1,False,0.16992500144231237,6,0,start0,aligned
22,study7Line,14.0,60,44,1820,44,stackbar,set3,0,0,True,-3.0,6,0,start0,aligned
22,study7Line,7.0,61,17,1821,18,stackbar,set4,-1,1,False,0.16992500144231237,7,0,start0,aligned
22,study7Line,5.0,62,10,1822,12,stackbar,set2,-2,2,False,1.0874628412503393,12,0,start0,aligned
22,study7Line,8.0,63,38,1823,39,stackbar,set1,-1,1,False,0.16992500144231237,11,4,non-aligned,non-aligned
22,study7Line,9.0,64,45,1824,48,stackbar,set1,-3,3,False,1.6438561897747246,2,9,non-aligned,non-aligned
22,study7Line,12.0,65,24,1825,24,stackbar,set2,0,0,True,-3.0,1,2,non-aligned,non-aligned
22,study7Line,18.0,66,30,1826,32,stackbar,set2,-2,2,False,1.0874628412503393,7,6,non-aligned,non-aligned
22,study7Line,9.0,67,40,1827,45,stackbar,set3,-5,5,False,2.357552004618084,5,7,non-aligned,non-aligned
22,study7Line,6.0,68,14,1828,15,stackbar,set1,-1,1,False,0.16992500144231237,10,5,non-aligned,non-aligned
22,study7Line,6.0,69,20,1829,20,stackbar,set1,0,0,True,-3.0,5,0,start75,aligned
22,study7Line,6.0,70,40,1830,43,stackbar,set2,-3,3,False,1.6438561897747246,7,0,start0,aligned
22,study7Line,6.0,71,20,1831,21,stackbar,set1,-1,1,False,0.16992500144231237,4,0,start0,aligned
22,study7Line,6.0,72,25,1832,25,stackbar,set4,0,0,True,-3.0,0,0,start25,aligned
22,study7Line,6.0,73,12,1833,13,stackbar,set2,-1,1,False,0.16992500144231237,12,0,start0,aligned
22,study7Line,4.0,74,10,1834,11,stackbar,set2,-1,1,False,0.16992500144231237,11,0,start0,aligned
22,study7Line,8.0,75,33,1835,35,stackbar,set3,-2,2,False,1.0874628412503393,10,0,start0,aligned
22,study7Line,5.0,76,10,1836,11,stackbar,set4,-1,1,False,0.16992500144231237,11,4,non-aligned,non-aligned
22,study7Line,7.0,77,23,1837,23,stackbar,set1,0,0,True,-3.0,2,3,non-aligned,non-aligned
22,study7Line,12.0,78,37,1838,40,stackbar,set1,-3,3,False,1.6438561897747246,10,6,non-aligned,non-aligned
22,study7Line,5.0,79,49,1839,49,stackbar,set1,0,0,True,-3.0,1,0,start0,aligned
10,study7Line,17.0,0,20,800,22,stackbar,set4,-2,2,False,1.0874628412503393,3,0,start0,aligned
10,study7Line,14.0,1,42,801,43,stackbar,set2,-1,1,False,0.16992500144231237,7,0,start0,aligned
10,study7Line,16.0,2,23,802,23,stackbar,set1,0,0,True,-3.0,2,3,non-aligned,non-aligned
10,study7Line,6.0,3,25,803,25,stackbar,set2,0,0,True,-3.0,0,0,start0,aligned
10,study7Line,22.0,4,64,804,38,stackbar,set1,26,26,False,4.7073591320808825,12,1,non-aligned,non-aligned
10,study7Line,37.0,5,43,805,42,stackbar,set1,1,1,False,0.16992500144231237,8,3,non-aligned,non-aligned
10,study7Line,12.0,6,43,806,46,stackbar,set2,-3,3,False,1.6438561897747246,4,0,start0,aligned
10,study7Line,20.0,7,47,807,36,stackbar,set3,11,11,False,3.4757334309663976,11,3,non-aligned,non-aligned
10,study7Line,13.0,8,22,808,23,stackbar,set2,-1,1,False,0.16992500144231237,2,0,start0,aligned
10,study7Line,17.0,9,31,809,32,stackbar,set2,-1,1,False,0.16992500144231237,7,0,start0,aligned
10,study7Line,11.0,10,43,810,45,stackbar,set2,-2,2,False,1.0874628412503393,5,0,start0,aligned
10,study7Line,10.0,11,46,811,22,stackbar,set3,24,24,False,4.592457037268081,3,2,non-aligned,non-aligned
10,study7Line,7.0,12,25,812,25,stackbar,set2,0,0,True,-3.0,0,8,non-aligned,non-aligned
10,study7Line,8.0,13,31,813,31,stackbar,set2,0,0,True,-3.0,6,0,start0,aligned
10,study7Line,10.0,14,11,814,11,stackbar,set4,0,0,True,-3.0,11,0,start0,aligned
10,study7Line,17.0,15,38,815,13,stackbar,set2,25,25,False,4.651051691178929,12,6,non-aligned,non-aligned
10,study7Line,25.0,16,43,816,46,stackbar,set2,-3,3,False,1.6438561897747246,4,9,non-aligned,non-aligned
10,study7Line,6.0,17,12,817,13,stackbar,set4,-1,1,False,0.16992500144231237,12,0,start0,aligned
10,study7Line,12.0,18,16,818,16,stackbar,set2,0,0,True,-3.0,9,2,non-aligned,non-aligned
10,study7Line,9.0,19,27,819,28,stackbar,set3,-1,1,False,0.16992500144231237,3,9,non-aligned,non-aligned
10,study7Line,9.0,20,43,820,45,stackbar,set2,-2,2,False,1.0874628412503393,5,9,non-aligned,non-aligned
10,study7Line,9.0,21,48,821,49,stackbar,set3,-1,1,False,0.16992500144231237,1,1,non-aligned,non-aligned
10,study7Line,13.0,22,31,822,27,stackbar,set3,4,4,False,2.0443941193584534,2,6,non-aligned,non-aligned
10,study7Line,19.0,23,33,823,33,stackbar,set1,0,0,True,-3.0,8,6,non-aligned,non-aligned
10,study7Line,8.0,24,25,824,24,stackbar,set3,1,1,False,0.16992500144231237,1,8,non-aligned,non-aligned
10,study7Line,18.0,25,12,825,14,stackbar,set1,-2,2,False,1.0874628412503393,11,5,non-aligned,non-aligned
10,study7Line,9.0,26,47,826,49,stackbar,set1,-2,2,False,1.0874628412503393,1,0,start0,aligned
10,study7Line,11.0,27,31,827,31,stackbar,set1,0,0,True,-3.0,6,4,non-aligned,non-aligned
10,study7Line,16.0,28,36,828,37,stackbar,set3,-1,1,False,0.16992500144231237,12,0,start0,aligned
10,study7Line,14.0,29,33,829,34,stackbar,set2,-1,1,False,0.16992500144231237,9,2,non-aligned,non-aligned
10,study7Line,10.0,30,38,830,40,stackbar,set4,-2,2,False,1.0874628412503393,10,0,start0,aligned
10,study7Line,11.0,31,50,831,50,stackbar,set4,0,0,True,-3.0,0,7,non-aligned,non-aligned
10,study7Line,13.0,32,37,832,37,stackbar,set1,0,0,True,-3.0,12,6,non-aligned,non-aligned
10,study7Line,21.0,33,43,833,39,stackbar,set4,4,4,False,2.0443941193584534,11,1,non-aligned,non-aligned
10,study7Line,8.0,34,34,834,35,stackbar,set1,-1,1,False,0.16992500144231237,10,0,start0,aligned
10,study7Line,5.0,35,23,835,24,stackbar,set4,-1,1,False,0.16992500144231237,1,0,start0,aligned
10,study7Line,10.0,36,37,836,38,stackbar,set2,-1,1,False,0.16992500144231237,12,0,start0,aligned
10,study7Line,13.0,37,31,837,29,stackbar,set2,2,2,False,1.0874628412503393,4,2,non-aligned,non-aligned
10,study7Line,7.0,38,38,838,39,stackbar,set1,-1,1,False,0.16992500144231237,11,0,start0,aligned
10,study7Line,9.0,39,12,839,14,stackbar,set4,-2,2,False,1.0874628412503393,11,0,start0,aligned
10,study7Line,38.0,40,41,840,41,stackbar,set2,0,0,True,-3.0,9,4,non-aligned,non-aligned
10,study7Line,17.0,41,18,841,20,stackbar,set1,-2,2,False,1.0874628412503393,5,0,start75,aligned
10,study7Line,9.0,42,33,842,34,stackbar,set2,-1,1,False,0.16992500144231237,9,0,start0,aligned
10,study7Line,4.0,43,50,843,50,stackbar,set1,0,0,True,-3.0,0,0,start0,aligned
10,study7Line,11.0,44,43,844,44,stackbar,set3,-1,1,False,0.16992500144231237,6,8,non-aligned,non-aligned
10,study7Line,9.0,45,20,845,11,stackbar,set4,9,9,False,3.189824558880017,11,4,non-aligned,non-aligned
10,study7Line,7.0,46,31,846,30,stackbar,set2,1,1,False,0.16992500144231237,5,4,non-aligned,non-aligned
10,study7Line,6.0,47,12,847,12,stackbar,set3,0,0,True,-3.0,12,0,start0,aligned
10,study7Line,13.0,48,18,848,21,stackbar,set1,-3,3,False,1.6438561897747246,4,0,start0,aligned
10,study7Line,17.0,49,41,849,40,stackbar,set1,1,1,False,0.16992500144231237,10,6,non-aligned,non-aligned
10,study7Line,15.0,50,37,850,43,stackbar,set4,-6,6,False,2.6147098441152083,7,6,non-aligned,non-aligned
10,study7Line,10.0,51,17,851,19,stackbar,set1,-2,2,False,1.0874628412503393,6,0,start0,aligned
10,study7Line,10.0,52,13,852,12,stackbar,set2,1,1,False,0.16992500144231237,12,1,non-aligned,non-aligned
10,study7Line,4.0,53,14,853,15,stackbar,set3,-1,1,False,0.16992500144231237,10,0,start0,aligned
10,study7Line,13.0,54,17,854,18,stackbar,set4,-1,1,False,0.16992500144231237,7,0,start0,aligned
10,study7Line,13.0,55,33,855,32,stackbar,set3,1,1,False,0.16992500144231237,7,2,non-aligned,non-aligned
10,study7Line,13.0,56,41,856,42,stackbar,set1,-1,1,False,0.16992500144231237,8,0,start0,aligned
10,study7Line,11.0,57,16,857,15,stackbar,set1,1,1,False,0.16992500144231237,10,5,non-aligned,non-aligned
10,study7Line,8.0,58,20,858,21,stackbar,set1,-1,1,False,0.16992500144231237,4,1,non-aligned,non-aligned
10,study7Line,11.0,59,41,859,47,stackbar,set4,-6,6,False,2.6147098441152083,3,10,non-aligned,non-aligned
10,study7Line,7.0,60,31,860,30,stackbar,set2,1,1,False,0.16992500144231237,5,0,start0,aligned
10,study7Line,13.0,61,35,861,35,stackbar,set3,0,0,True,-3.0,10,2,non-aligned,non-aligned
10,study7Line,11.0,62,47,862,48,stackbar,set1,-1,1,False,0.16992500144231237,2,0,start0,aligned
10,study7Line,10.0,63,30,863,29,stackbar,set3,1,1,False,0.16992500144231237,4,0,start0,aligned
10,study7Line,7.0,64,33,864,33,stackbar,set2,0,0,True,-3.0,8,0,start0,aligned
10,study7Line,10.0,65,34,865,36,stackbar,set2,-2,2,False,1.0874628412503393,11,0,start0,aligned
10,study7Line,15.0,66,43,866,48,stackbar,set3,-5,5,False,2.357552004618084,2,2,non-aligned,non-aligned
10,study7Line,11.0,67,18,867,20,stackbar,set1,-2,2,False,1.0874628412503393,5,0,start0,aligned
10,study7Line,9.0,68,28,868,27,stackbar,set3,1,1,False,0.16992500144231237,2,0,start0,aligned
10,study7Line,11.0,69,15,869,16,stackbar,set4,-1,1,False,0.16992500144231237,9,0,start0,aligned
10,study7Line,7.0,70,29,870,28,stackbar,set2,1,1,False,0.16992500144231237,3,0,start0,aligned
10,study7Line,26.0,71,39,871,41,stackbar,set1,-2,2,False,1.0874628412503393,9,0,start0,aligned
10,study7Line,7.0,72,14,872,17,stackbar,set4,-3,3,False,1.6438561897747246,8,0,start0,aligned
10,study7Line,5.0,73,27,873,26,stackbar,set2,1,1,False,0.16992500144231237,1,0,start0,aligned
10,study7Line,17.0,74,42,874,44,stackbar,set1,-2,2,False,1.0874628412503393,6,0,start0,aligned
10,study7Line,14.0,75,44,875,47,stackbar,set3,-3,3,False,1.6438561897747246,3,0,start0,aligned
10,study7Line,13.0,76,18,876,19,stackbar,set3,-1,1,False,0.16992500144231237,6,1,non-aligned,non-aligned
10,study7Line,14.0,77,18,877,18,stackbar,set3,0,0,True,-3.0,7,2,non-aligned,non-aligned
10,study7Line,9.0,78,16,878,17,stackbar,set1,-1,1,False,0.16992500144231237,8,0,start25,aligned
10,study7Line,7.0,79,27,879,26,stackbar,set1,1,1,False,0.16992500144231237,1,3,non-aligned,non-aligned
27,study7Line,15.0,0,50,2160,48,stackbar,set1,2,2,False,1.0874628412503393,2,9,non-aligned,non-aligned
27,study7Line,9.0,1,50,2161,50,stackbar,set1,0,0,True,-3.0,0,6,non-aligned,non-aligned
27,study7Line,6.0,2,30,2162,34,stackbar,set1,-4,4,False,2.0443941193584534,9,0,start0,aligned
27,study7Line,6.0,3,15,2163,13,stackbar,set2,2,2,False,1.0874628412503393,12,0,start0,aligned
27,study7Line,6.0,4,25,2164,28,stackbar,set2,-3,3,False,1.6438561897747246,3,8,non-aligned,non-aligned
27,study7Line,8.0,5,50,2165,46,stackbar,set2,4,4,False,2.0443941193584534,4,9,non-aligned,non-aligned
27,study7Line,5.0,6,24,2166,24,stackbar,set1,0,0,True,-3.0,1,0,start0,aligned
27,study7Line,13.0,7,38,2167,38,stackbar,set3,0,0,True,-3.0,12,0,start0,aligned
27,study7Line,7.0,8,10,2168,11,stackbar,set1,-1,1,False,0.16992500144231237,11,0,start0,aligned
27,study7Line,6.0,9,25,2169,27,stackbar,set2,-2,2,False,1.0874628412503393,2,11,non-aligned,non-aligned
27,study7Line,5.0,10,10,2170,11,stackbar,set3,-1,1,False,0.16992500144231237,11,5,non-aligned,non-aligned
27,study7Line,3.0,11,23,2171,23,stackbar,set3,0,0,True,-3.0,2,0,start0,aligned
27,study7Line,6.0,12,30,2172,36,stackbar,set3,-6,6,False,2.6147098441152083,11,3,non-aligned,non-aligned
27,study7Line,5.0,13,28,2173,29,stackbar,set4,-1,1,False,0.16992500144231237,4,0,start0,aligned
27,study7Line,7.0,14,28,2174,29,stackbar,set4,-1,1,False,0.16992500144231237,4,3,non-aligned,non-aligned
27,study7Line,5.0,15,40,2175,40,stackbar,set2,0,0,True,-3.0,10,0,start0,aligned
27,study7Line,6.0,16,15,2176,14,stackbar,set4,1,1,False,0.16992500144231237,11,6,non-aligned,non-aligned
27,study7Line,6.0,17,30,2177,33,stackbar,set2,-3,3,False,1.6438561897747246,8,8,non-aligned,non-aligned
27,study7Line,8.0,18,30,2178,17,stackbar,set1,13,13,False,3.7142455176661224,8,0,start25,aligned
27,study7Line,5.0,19,40,2179,37,stackbar,set2,3,3,False,1.6438561897747246,12,5,non-aligned,non-aligned
27,study7Line,7.0,20,30,2180,18,stackbar,set1,12,12,False,3.599912842187128,7,1,non-aligned,non-aligned
27,study7Line,7.0,21,46,2181,47,stackbar,set2,-1,1,False,0.16992500144231237,3,0,start0,aligned
27,study7Line,7.0,22,40,2182,39,stackbar,set2,1,1,False,0.16992500144231237,11,1,non-aligned,non-aligned
27,study7Line,6.0,23,15,2183,14,stackbar,set2,1,1,False,0.16992500144231237,11,0,start0,aligned
27,study7Line,6.0,24,20,2184,16,stackbar,set3,4,4,False,2.0443941193584534,9,3,non-aligned,non-aligned
27,study7Line,5.0,25,40,2185,38,stackbar,set4,2,2,False,1.0874628412503393,12,6,non-aligned,non-aligned
27,study7Line,5.0,26,25,2186,23,stackbar,set2,2,2,False,1.0874628412503393,2,5,non-aligned,non-aligned
27,study7Line,8.0,27,50,2187,44,stackbar,set2,6,6,False,2.6147098441152083,6,9,non-aligned,non-aligned
27,study7Line,9.0,28,28,2188,30,stackbar,set3,-2,2,False,1.0874628412503393,5,0,start0,aligned
27,study7Line,5.0,29,45,2189,45,stackbar,set4,0,0,True,-3.0,5,0,start0,aligned
27,study7Line,4.0,30,15,2190,15,stackbar,set3,0,0,True,-3.0,10,0,start0,aligned
27,study7Line,5.0,31,30,2191,31,stackbar,set2,-1,1,False,0.16992500144231237,6,1,non-aligned,non-aligned
27,study7Line,5.0,32,35,2192,36,stackbar,set4,-1,1,False,0.16992500144231237,11,0,start0,aligned
27,study7Line,4.0,33,25,2193,24,stackbar,set4,1,1,False,0.16992500144231237,1,9,non-aligned,non-aligned
27,study7Line,3.0,34,26,2194,26,stackbar,set4,0,0,True,-3.0,1,0,start0,aligned
27,study7Line,6.0,35,30,2195,34,stackbar,set3,-4,4,False,2.0443941193584534,9,3,non-aligned,non-aligned
27,study7Line,6.0,36,45,2196,49,stackbar,set3,-4,4,False,2.0443941193584534,1,1,non-aligned,non-aligned
27,study7Line,3.0,37,20,2197,19,stackbar,set2,1,1,False,0.16992500144231237,6,0,start0,aligned
27,study7Line,6.0,38,30,2198,32,stackbar,set3,-2,2,False,1.0874628412503393,7,0,start0,aligned
27,study7Line,4.0,39,20,2199,19,stackbar,set3,1,1,False,0.16992500144231237,6,1,non-aligned,non-aligned
27,study7Line,6.0,40,40,2200,41,stackbar,set3,-1,1,False,0.16992500144231237,9,1,non-aligned,non-aligned
27,study7Line,7.0,41,20,2201,20,stackbar,set1,0,0,True,-3.0,5,0,start0,aligned
27,study7Line,5.0,42,45,2202,46,stackbar,set4,-1,1,False,0.16992500144231237,4,0,start0,aligned
27,study7Line,9.0,43,20,2203,20,stackbar,set4,0,0,True,-3.0,5,5,non-aligned,non-aligned
27,study7Line,6.0,44,45,2204,47,stackbar,set4,-2,2,False,1.0874628412503393,3,10,non-aligned,non-aligned
27,study7Line,5.0,45,20,2205,18,stackbar,set3,2,2,False,1.0874628412503393,7,0,start0,aligned
27,study7Line,4.0,46,48,2206,49,stackbar,set4,-1,1,False,0.16992500144231237,1,0,start0,aligned
27,study7Line,6.0,47,45,2207,45,stackbar,set1,0,0,True,-3.0,5,2,non-aligned,non-aligned
27,study7Line,6.0,48,30,2208,31,stackbar,set1,-1,1,False,0.16992500144231237,6,0,start0,aligned
27,study7Line,7.0,49,40,2209,44,stackbar,set1,-4,4,False,2.0443941193584534,6,0,start0,aligned
27,study7Line,8.0,50,40,2210,40,stackbar,set3,0,0,True,-3.0,10,2,non-aligned,non-aligned
27,study7Line,6.0,51,35,2211,41,stackbar,set3,-6,6,False,2.6147098441152083,9,0,start0,aligned
27,study7Line,7.0,52,28,2212,22,stackbar,set2,6,6,False,2.6147098441152083,3,0,start0,aligned
27,study7Line,6.0,53,20,2213,13,stackbar,set2,7,7,False,2.8328900141647417,12,6,non-aligned,non-aligned
27,study7Line,6.0,54,50,2214,50,stackbar,set4,0,0,True,-3.0,0,0,start0,aligned
27,study7Line,5.0,55,15,2215,17,stackbar,set4,-2,2,False,1.0874628412503393,8,0,start0,aligned
27,study7Line,6.0,56,20,2216,22,stackbar,set2,-2,2,False,1.0874628412503393,3,9,non-aligned,non-aligned
27,study7Line,5.0,57,35,2217,35,stackbar,set4,0,0,True,-3.0,10,0,start0,aligned
27,study7Line,7.0,58,25,2218,12,stackbar,set3,13,13,False,3.7142455176661224,12,1,non-aligned,non-aligned
27,study7Line,5.0,59,15,2219,15,stackbar,set2,0,0,True,-3.0,10,4,non-aligned,non-aligned
27,study7Line,4.0,60,10,2220,12,stackbar,set4,-2,2,False,1.0874628412503393,12,0,start0,aligned
27,study7Line,5.0,61,40,2221,42,stackbar,set4,-2,2,False,1.0874628412503393,8,1,non-aligned,non-aligned
27,study7Line,8.0,62,15,2222,16,stackbar,set4,-1,1,False,0.16992500144231237,9,0,start0,aligned
27,study7Line,5.0,63,25,2223,26,stackbar,set4,-1,1,False,0.16992500144231237,1,1,non-aligned,non-aligned
27,study7Line,5.0,64,27,2224,27,stackbar,set3,0,0,True,-3.0,2,0,start0,aligned
27,study7Line,5.0,65,35,2225,37,stackbar,set4,-2,2,False,1.0874628412503393,12,0,start0,aligned
27,study7Line,6.0,66,35,2226,32,stackbar,set1,3,3,False,1.6438561897747246,7,2,non-aligned,non-aligned
27,study7Line,5.0,67,47,2227,48,stackbar,set3,-1,1,False,0.16992500144231237,2,0,start0,aligned
27,study7Line,5.0,68,35,2228,39,stackbar,set2,-4,4,False,2.0443941193584534,11,0,start0,aligned
27,study7Line,3.0,69,27,2229,28,stackbar,set4,-1,1,False,0.16992500144231237,3,0,start0,aligned
27,study7Line,5.0,70,21,2230,21,stackbar,set3,0,0,True,-3.0,4,0,start0,aligned
27,study7Line,5.0,71,25,2231,25,stackbar,set1,0,0,True,-3.0,0,0,start0,aligned
27,study7Line,5.0,72,35,2232,43,stackbar,set4,-8,8,False,3.0223678130284544,7,6,non-aligned,non-aligned
27,study7Line,6.0,73,30,2233,35,stackbar,set1,-5,5,False,2.357552004618084,10,6,non-aligned,non-aligned
27,study7Line,4.0,74,40,2234,42,stackbar,set3,-2,2,False,1.0874628412503393,8,0,start0,aligned
27,study7Line,4.0,75,35,2235,33,stackbar,set1,2,2,False,1.0874628412503393,8,0,start0,aligned
27,study7Line,4.0,76,26,2236,21,stackbar,set1,5,5,False,2.357552004618084,4,1,non-aligned,non-aligned
27,study7Line,5.0,77,28,2237,30,stackbar,set2,-2,2,False,1.0874628412503393,5,4,non-aligned,non-aligned
27,study7Line,6.0,78,21,2238,25,stackbar,set1,-4,4,False,2.0443941193584534,0,7,non-aligned,non-aligned
27,study7Line,4.0,79,40,2239,43,stackbar,set4,-3,3,False,1.6438561897747246,7,0,start0,aligned
8,study7Line,20.0,0,25,640,24,stackbar,set4,1,1,False,0.16992500144231237,1,9,non-aligned,non-aligned
8,study7Line,10.0,1,18,641,17,stackbar,set3,1,1,False,0.16992500144231237,8,0,start0,aligned
8,study7Line,17.0,2,28,642,28,stackbar,set1,0,0,True,-3.0,3,0,start0,aligned
8,study7Line,18.0,3,39,643,42,stackbar,set1,-3,3,False,1.6438561897747246,8,3,non-aligned,non-aligned
8,study7Line,14.0,4,43,644,41,stackbar,set4,2,2,False,1.0874628412503393,9,4,non-aligned,non-aligned
8,study7Line,6.0,5,27,645,27,stackbar,set2,0,0,True,-3.0,2,0,start0,aligned
8,study7Line,13.0,6,20,646,19,stackbar,set2,1,1,False,0.16992500144231237,6,2,non-aligned,non-aligned
8,study7Line,6.0,7,20,647,19,stackbar,set1,1,1,False,0.16992500144231237,6,0,start0,aligned
8,study7Line,11.0,8,35,648,40,stackbar,set1,-5,5,False,2.357552004618084,10,6,non-aligned,non-aligned
8,study7Line,10.0,9,48,649,49,stackbar,set2,-1,1,False,0.16992500144231237,1,0,start0,aligned
8,study7Line,19.0,10,14,650,14,stackbar,set4,0,0,True,-3.0,11,6,non-aligned,non-aligned
8,study7Line,9.0,11,40,651,41,stackbar,set1,-1,1,False,0.16992500144231237,9,0,start0,aligned
8,study7Line,21.0,12,38,652,36,stackbar,set3,2,2,False,1.0874628412503393,11,3,non-aligned,non-aligned
8,study7Line,9.0,13,11,653,11,stackbar,set2,0,0,True,-3.0,11,0,start0,aligned
8,study7Line,6.0,14,25,654,29,stackbar,set3,-4,4,False,2.0443941193584534,4,9,non-aligned,non-aligned
8,study7Line,16.0,15,26,655,26,stackbar,set2,0,0,True,-3.0,1,10,non-aligned,non-aligned
8,study7Line,19.0,16,22,656,25,stackbar,set3,-3,3,False,1.6438561897747246,0,5,non-aligned,non-aligned
8,study7Line,9.0,17,42,657,43,stackbar,set2,-1,1,False,0.16992500144231237,7,0,start0,aligned
8,study7Line,10.0,18,13,658,14,stackbar,set4,-1,1,False,0.16992500144231237,11,0,start0,aligned
8,study7Line,12.0,19,39,659,39,stackbar,set1,0,0,True,-3.0,11,4,non-aligned,non-aligned
8,study7Line,15.0,20,14,660,13,stackbar,set1,1,1,False,0.16992500144231237,12,6,non-aligned,non-aligned
8,study7Line,9.0,21,12,661,12,stackbar,set4,0,0,True,-3.0,12,6,non-aligned,non-aligned
8,study7Line,8.0,22,17,662,16,stackbar,set1,1,1,False,0.16992500144231237,9,1,non-aligned,non-aligned
8,study7Line,7.0,23,17,663,16,stackbar,set3,1,1,False,0.16992500144231237,9,0,start0,aligned
8,study7Line,7.0,24,43,664,42,stackbar,set2,1,1,False,0.16992500144231237,8,0,start0,aligned
8,study7Line,7.0,25,11,665,13,stackbar,set2,-2,2,False,1.0874628412503393,12,0,start0,aligned
8,study7Line,6.0,26,37,666,38,stackbar,set1,-1,1,False,0.16992500144231237,12,0,start0,aligned
8,study7Line,14.0,27,9,667,11,stackbar,set2,-2,2,False,1.0874628412503393,11,2,non-aligned,non-aligned
8,study7Line,6.0,28,45,668,46,stackbar,set1,-1,1,False,0.16992500144231237,4,0,start0,aligned
8,study7Line,11.0,29,47,669,47,stackbar,set2,0,0,True,-3.0,3,2,non-aligned,non-aligned
8,study7Line,10.0,30,21,670,21,stackbar,set1,0,0,True,-3.0,4,1,non-aligned,non-aligned
8,study7Line,7.0,31,19,671,18,stackbar,set4,1,1,False,0.16992500144231237,7,3,non-aligned,non-aligned
8,study7Line,5.0,32,46,672,47,stackbar,set2,-1,1,False,0.16992500144231237,3,0,start0,aligned
8,study7Line,14.0,33,46,673,50,stackbar,set4,-4,4,False,2.0443941193584534,0,7,non-aligned,non-aligned
8,study7Line,17.0,34,27,674,23,stackbar,set3,4,4,False,2.0443941193584534,2,10,non-aligned,non-aligned
8,study7Line,5.0,35,20,675,20,stackbar,set3,0,0,True,-3.0,5,0,start0,aligned
8,study7Line,10.0,36,42,676,44,stackbar,set3,-2,2,False,1.0874628412503393,6,0,start0,aligned
8,study7Line,9.0,37,40,677,40,stackbar,set1,0,0,True,-3.0,10,0,start0,aligned
8,study7Line,15.0,38,37,678,37,stackbar,set1,0,0,True,-3.0,12,0,start0,aligned
8,study7Line,5.0,39,50,679,50,stackbar,set3,0,0,True,-3.0,0,0,start0,aligned
8,study7Line,4.0,40,35,680,34,stackbar,set2,1,1,False,0.16992500144231237,9,0,start0,aligned
8,study7Line,6.0,41,20,681,18,stackbar,set3,2,2,False,1.0874628412503393,7,0,start0,aligned
8,study7Line,9.0,42,15,682,15,stackbar,set1,0,0,True,-3.0,10,5,non-aligned,non-aligned
8,study7Line,5.0,43,30,683,30,stackbar,set2,0,0,True,-3.0,5,0,start0,aligned
8,study7Line,8.0,44,50,684,49,stackbar,set2,1,1,False,0.16992500144231237,1,8,non-aligned,non-aligned
8,study7Line,8.0,45,24,685,35,stackbar,set2,-11,11,False,3.4757334309663976,10,3,non-aligned,non-aligned
8,study7Line,24.0,46,45,686,44,stackbar,set2,1,1,False,0.16992500144231237,6,9,non-aligned,non-aligned
8,study7Line,6.0,47,25,687,28,stackbar,set1,-3,3,False,1.6438561897747246,3,10,non-aligned,non-aligned
8,study7Line,8.0,48,30,688,37,stackbar,set2,-7,7,False,2.8328900141647417,12,5,non-aligned,non-aligned
8,study7Line,9.0,49,40,689,38,stackbar,set4,2,2,False,1.0874628412503393,12,6,non-aligned,non-aligned
8,study7Line,5.0,50,30,690,31,stackbar,set2,-1,1,False,0.16992500144231237,6,0,start0,aligned
8,study7Line,10.0,51,42,691,45,stackbar,set1,-3,3,False,1.6438561897747246,5,2,non-aligned,non-aligned
8,study7Line,5.0,52,17,692,15,stackbar,set2,2,2,False,1.0874628412503393,10,0,start0,aligned
8,study7Line,14.0,53,28,693,27,stackbar,set2,1,1,False,0.16992500144231237,2,11,non-aligned,non-aligned
8,study7Line,7.0,54,43,694,43,stackbar,set4,0,0,True,-3.0,7,6,non-aligned,non-aligned
8,study7Line,7.0,55,21,695,21,stackbar,set4,0,0,True,-3.0,4,0,start0,aligned
8,study7Line,9.0,56,50,696,46,stackbar,set1,4,4,False,2.0443941193584534,4,6,non-aligned,non-aligned
8,study7Line,10.0,57,32,697,39,stackbar,set3,-7,7,False,2.8328900141647417,11,0,start0,aligned
8,study7Line,12.0,58,33,698,34,stackbar,set2,-1,1,False,0.16992500144231237,9,2,non-aligned,non-aligned
8,study7Line,5.0,59,25,699,32,stackbar,set4,-7,7,False,2.8328900141647417,7,7,non-aligned,non-aligned
8,study7Line,4.0,60,47,700,48,stackbar,set2,-1,1,False,0.16992500144231237,2,0,start0,aligned
8,study7Line,4.0,61,25,701,25,stackbar,set3,0,0,True,-3.0,0,0,start0,aligned
8,study7Line,9.0,62,35,702,36,stackbar,set2,-1,1,False,0.16992500144231237,11,0,start0,aligned
8,study7Line,11.0,63,27,703,33,stackbar,set1,-6,6,False,2.6147098441152083,8,6,non-aligned,non-aligned
8,study7Line,11.0,64,32,704,30,stackbar,set3,2,2,False,1.0874628412503393,5,7,non-aligned,non-aligned
8,study7Line,7.0,65,22,705,23,stackbar,set1,-1,1,False,0.16992500144231237,2,0,start0,aligned
8,study7Line,5.0,66,35,706,35,stackbar,set4,0,0,True,-3.0,10,0,start0,aligned
8,study7Line,8.0,67,41,707,45,stackbar,set3,-4,4,False,2.0443941193584534,5,0,start0,aligned
8,study7Line,6.0,68,20,708,20,stackbar,set1,0,0,True,-3.0,5,0,start75,aligned
8,study7Line,4.0,69,21,709,22,stackbar,set1,-1,1,False,0.16992500144231237,3,0,start0,aligned
8,study7Line,7.0,70,30,710,31,stackbar,set2,-1,1,False,0.16992500144231237,6,1,non-aligned,non-aligned
8,study7Line,6.0,71,30,711,29,stackbar,set1,1,1,False,0.16992500144231237,4,0,start0,aligned
8,study7Line,4.0,72,26,712,26,stackbar,set3,0,0,True,-3.0,1,0,start0,aligned
8,study7Line,5.0,73,24,713,24,stackbar,set4,0,0,True,-3.0,1,0,start0,aligned
8,study7Line,4.0,74,35,714,32,stackbar,set1,3,3,False,1.6438561897747246,7,0,start0,aligned
8,study7Line,10.0,75,22,715,22,stackbar,set2,0,0,True,-3.0,3,9,non-aligned,non-aligned
8,study7Line,10.0,76,46,716,48,stackbar,set2,-2,2,False,1.0874628412503393,2,2,non-aligned,non-aligned
8,study7Line,6.0,77,11,717,12,stackbar,set1,-1,1,False,0.16992500144231237,12,0,start0,aligned
8,study7Line,4.0,78,33,718,33,stackbar,set4,0,0,True,-3.0,8,0,start0,aligned
8,study7Line,10.0,79,17,719,17,stackbar,set4,0,0,True,-3.0,8,1,non-aligned,non-aligned
32,study7Line,10.0,0,40,2560,37,stackbar,set4,3,3,False,1.6438561897747246,12,1,non-aligned,non-aligned
32,study7Line,14.0,1,35,2561,35,stackbar,set4,0,0,True,-3.0,10,0,start0,aligned
32,study7Line,11.0,2,15,2562,17,stackbar,set4,-2,2,False,1.0874628412503393,8,0,start0,aligned
32,study7Line,15.0,3,15,2563,12,stackbar,set2,3,3,False,1.6438561897747246,12,1,non-aligned,non-aligned
32,study7Line,10.0,4,20,2564,20,stackbar,set3,0,0,True,-3.0,5,2,non-aligned,non-aligned
32,study7Line,14.0,5,25,2565,40,stackbar,set2,-15,15,False,3.9188632372745946,10,0,start0,aligned
32,study7Line,13.0,6,30,2566,28,stackbar,set3,2,2,False,1.0874628412503393,3,9,non-aligned,non-aligned
32,study7Line,8.0,7,50,2567,43,stackbar,set1,7,7,False,2.8328900141647417,7,2,non-aligned,non-aligned
32,study7Line,6.0,8,20,2568,23,stackbar,set2,-3,3,False,1.6438561897747246,2,0,start0,aligned
32,study7Line,14.0,9,25,2569,23,stackbar,set4,2,2,False,1.0874628412503393,2,10,non-aligned,non-aligned
32,study7Line,7.0,10,15,2570,17,stackbar,set1,-2,2,False,1.0874628412503393,8,0,start25,aligned
32,study7Line,7.0,11,20,2571,22,stackbar,set2,-2,2,False,1.0874628412503393,3,0,start0,aligned
32,study7Line,11.0,12,18,2572,16,stackbar,set4,2,2,False,1.0874628412503393,9,0,start0,aligned
32,study7Line,9.0,13,38,2573,39,stackbar,set3,-1,1,False,0.16992500144231237,11,0,start0,aligned
32,study7Line,7.0,14,50,2574,41,stackbar,set3,9,9,False,3.189824558880017,9,1,non-aligned,non-aligned
32,study7Line,7.0,15,10,2575,11,stackbar,set4,-1,1,False,0.16992500144231237,11,0,start0,aligned
32,study7Line,9.0,16,25,2576,33,stackbar,set2,-8,8,False,3.0223678130284544,8,8,non-aligned,non-aligned
32,study7Line,30.0,17,20,2577,15,stackbar,set2,5,5,False,2.357552004618084,10,0,start0,aligned
32,study7Line,14.0,18,23,2578,21,stackbar,set4,2,2,False,1.0874628412503393,4,0,start0,aligned
32,study7Line,7.0,19,47,2579,49,stackbar,set3,-2,2,False,1.0874628412503393,1,0,start0,aligned
32,study7Line,7.0,20,10,2580,11,stackbar,set1,-1,1,False,0.16992500144231237,11,4,non-aligned,non-aligned
32,study7Line,7.0,21,28,2581,27,stackbar,set2,1,1,False,0.16992500144231237,2,0,start0,aligned
32,study7Line,7.0,22,25,2582,29,stackbar,set4,-4,4,False,2.0443941193584534,4,3,non-aligned,non-aligned
32,study7Line,8.0,23,50,2583,40,stackbar,set1,10,10,False,3.3398500028846247,10,6,non-aligned,non-aligned
32,study7Line,8.0,24,38,2584,37,stackbar,set3,1,1,False,0.16992500144231237,12,0,start0,aligned
32,study7Line,8.0,25,35,2585,36,stackbar,set4,-1,1,False,0.16992500144231237,11,0,start0,aligned
32,study7Line,8.0,26,30,2586,31,stackbar,set4,-1,1,False,0.16992500144231237,6,0,end50,aligned
32,study7Line,7.0,27,23,2587,19,stackbar,set3,4,4,False,2.0443941193584534,6,1,non-aligned,non-aligned
32,study7Line,6.0,28,25,2588,27,stackbar,set3,-2,2,False,1.0874628412503393,2,6,non-aligned,non-aligned
32,study7Line,6.0,29,27,2589,26,stackbar,set3,1,1,False,0.16992500144231237,1,0,start0,aligned
32,study7Line,11.0,30,40,2590,34,stackbar,set4,6,6,False,2.6147098441152083,9,2,non-aligned,non-aligned
32,study7Line,8.0,31,47,2591,49,stackbar,set3,-2,2,False,1.0874628412503393,1,1,non-aligned,non-aligned
32,study7Line,9.0,32,33,2592,32,stackbar,set2,1,1,False,0.16992500144231237,7,0,start0,aligned
32,study7Line,7.0,33,43,2593,44,stackbar,set4,-1,1,False,0.16992500144231237,6,0,start0,aligned
32,study7Line,11.0,34,15,2594,13,stackbar,set4,2,2,False,1.0874628412503393,12,6,non-aligned,non-aligned
32,study7Line,8.0,35,40,2595,45,stackbar,set4,-5,5,False,2.357552004618084,5,0,start0,aligned
32,study7Line,15.0,36,30,2596,29,stackbar,set4,1,1,False,0.16992500144231237,4,0,start0,aligned
32,study7Line,8.0,37,42,2597,41,stackbar,set4,1,1,False,0.16992500144231237,9,0,start0,aligned
32,study7Line,9.0,38,16,2598,15,stackbar,set1,1,1,False,0.16992500144231237,10,5,non-aligned,non-aligned
32,study7Line,12.0,39,50,2599,47,stackbar,set2,3,3,False,1.6438561897747246,3,2,non-aligned,non-aligned
32,study7Line,10.0,40,15,2600,16,stackbar,set2,-1,1,False,0.16992500144231237,9,2,non-aligned,non-aligned
32,study7Line,14.0,41,18,2601,18,stackbar,set1,0,0,True,-3.0,7,0,start0,aligned
32,study7Line,6.0,42,40,2602,46,stackbar,set2,-6,6,False,2.6147098441152083,4,0,start0,aligned
32,study7Line,7.0,43,50,2603,50,stackbar,set2,0,0,True,-3.0,0,4,non-aligned,non-aligned
32,study7Line,8.0,44,25,2604,22,stackbar,set1,3,3,False,1.6438561897747246,3,2,non-aligned,non-aligned
32,study7Line,11.0,45,47,2605,44,stackbar,set4,3,3,False,1.6438561897747246,6,2,non-aligned,non-aligned
32,study7Line,9.0,46,30,2606,28,stackbar,set4,2,2,False,1.0874628412503393,3,0,start0,aligned
32,study7Line,6.0,47,25,2607,24,stackbar,set1,1,1,False,0.16992500144231237,1,5,non-aligned,non-aligned
32,study7Line,11.0,48,30,2608,30,stackbar,set3,0,0,True,-3.0,5,7,non-aligned,non-aligned
32,study7Line,5.0,49,23,2609,24,stackbar,set1,-1,1,False,0.16992500144231237,1,0,start0,aligned
32,study7Line,11.0,50,24,2610,26,stackbar,set1,-2,2,False,1.0874628412503393,1,3,non-aligned,non-aligned
32,study7Line,8.0,51,13,2611,14,stackbar,set4,-1,1,False,0.16992500144231237,11,0,start0,aligned
32,study7Line,6.0,52,25,2612,25,stackbar,set3,0,0,True,-3.0,0,5,non-aligned,non-aligned
32,study7Line,7.0,53,42,2613,43,stackbar,set3,-1,1,False,0.16992500144231237,7,0,start0,aligned
32,study7Line,7.0,54,37,2614,38,stackbar,set1,-1,1,False,0.16992500144231237,12,0,start0,aligned
32,study7Line,9.0,55,50,2615,36,stackbar,set1,14,14,False,3.820178962415188,11,3,non-aligned,non-aligned
32,study7Line,12.0,56,46,2616,39,stackbar,set3,7,7,False,2.8328900141647417,11,3,non-aligned,non-aligned
32,study7Line,9.0,57,20,2617,20,stackbar,set1,0,0,True,-3.0,5,0,start0,aligned
32,study7Line,8.0,58,60,2618,46,stackbar,set3,14,14,False,3.820178962415188,4,10,non-aligned,non-aligned
32,study7Line,8.0,59,22,2619,19,stackbar,set2,3,3,False,1.6438561897747246,6,0,start0,aligned
32,study7Line,5.0,60,25,2620,25,stackbar,set4,0,0,True,-3.0,0,0,start0,aligned
32,study7Line,7.0,61,53,2621,45,stackbar,set4,8,8,False,3.0223678130284544,5,7,non-aligned,non-aligned
32,study7Line,7.0,62,47,2622,47,stackbar,set2,0,0,True,-3.0,3,0,start0,aligned
32,study7Line,6.0,63,15,2623,13,stackbar,set3,2,2,False,1.0874628412503393,12,0,start0,aligned
32,study7Line,9.0,64,30,2624,35,stackbar,set2,-5,5,False,2.357552004618084,10,3,non-aligned,non-aligned
32,study7Line,7.0,65,48,2625,48,stackbar,set4,0,0,True,-3.0,2,0,start0,aligned
32,study7Line,9.0,66,27,2626,32,stackbar,set1,-5,5,False,2.357552004618084,7,2,non-aligned,non-aligned
32,study7Line,10.0,67,40,2627,38,stackbar,set3,2,2,False,1.0874628412503393,12,3,non-aligned,non-aligned
32,study7Line,8.0,68,13,2628,14,stackbar,set2,-1,1,False,0.16992500144231237,11,4,non-aligned,non-aligned
32,study7Line,10.0,69,47,2629,42,stackbar,set3,5,5,False,2.357552004618084,8,7,non-aligned,non-aligned
32,study7Line,6.0,70,50,2630,50,stackbar,set2,0,0,True,-3.0,0,0,start0,aligned
32,study7Line,9.0,71,50,2631,48,stackbar,set1,2,2,False,1.0874628412503393,2,9,non-aligned,non-aligned
32,study7Line,5.0,72,25,2632,21,stackbar,set2,4,4,False,2.0443941193584534,4,6,non-aligned,non-aligned
32,study7Line,11.0,73,33,2633,33,stackbar,set3,0,0,True,-3.0,8,0,start0,aligned
32,study7Line,8.0,74,34,2634,34,stackbar,set1,0,0,True,-3.0,9,0,start0,aligned
32,study7Line,6.0,75,20,2635,18,stackbar,set4,2,2,False,1.0874628412503393,7,3,non-aligned,non-aligned
32,study7Line,6.0,76,12,2636,12,stackbar,set3,0,0,True,-3.0,12,0,start0,aligned
32,study7Line,7.0,77,40,2637,42,stackbar,set2,-2,2,False,1.0874628412503393,8,0,start0,aligned
32,study7Line,7.0,78,30,2638,30,stackbar,set2,0,0,True,-3.0,5,0,start0,aligned
32,study7Line,7.0,79,33,2639,31,stackbar,set3,2,2,False,1.0874628412503393,6,0,start0,aligned
1,study7Line,87.0,0,24,80,24,stackbar,set2,0,0,True,-3.0,1,0,start0,aligned
1,study7Line,83.0,1,50,81,50,stackbar,set1,0,0,True,-3.0,0,6,non-aligned,non-aligned
1,study7Line,92.0,2,13,82,14,stackbar,set1,-1,1,False,0.16992500144231237,11,5,non-aligned,non-aligned
1,study7Line,28.0,3,50,83,50,stackbar,set3,0,0,True,-3.0,0,0,start0,aligned
1,study7Line,49.0,4,20,84,20,stackbar,set3,0,0,True,-3.0,5,2,non-aligned,non-aligned
1,study7Line,37.0,5,28,85,29,stackbar,set1,-1,1,False,0.16992500144231237,4,2,non-aligned,non-aligned
1,study7Line,51.0,6,18,86,16,stackbar,set3,2,2,False,1.0874628412503393,9,3,non-aligned,non-aligned
1,study7Line,30.0,7,46,87,48,stackbar,set4,-2,2,False,1.0874628412503393,2,0,start0,aligned
1,study7Line,37.0,8,27,88,27,stackbar,set2,0,0,True,-3.0,2,11,non-aligned,non-aligned
1,study7Line,69.0,9,22,89,21,stackbar,set2,1,1,False,0.16992500144231237,4,0,start0,aligned
1,study7Line,37.0,10,35,90,37,stackbar,set4,-2,2,False,1.0874628412503393,12,1,non-aligned,non-aligned
1,study7Line,26.0,11,12,91,12,stackbar,set3,0,0,True,-3.0,12,0,start0,aligned
1,study7Line,687.0,12,40,92,38,stackbar,set2,2,2,False,1.0874628412503393,12,5,non-aligned,non-aligned
1,study7Line,38.0,13,37,93,36,stackbar,set4,1,1,False,0.16992500144231237,11,3,non-aligned,non-aligned
1,study7Line,14.0,14,26,94,28,stackbar,set4,-2,2,False,1.0874628412503393,3,5,non-aligned,non-aligned
1,study7Line,22.0,15,27,95,29,stackbar,set3,-2,2,False,1.0874628412503393,4,0,start0,aligned
1,study7Line,16.0,16,37,96,38,stackbar,set1,-1,1,False,0.16992500144231237,12,0,start0,aligned
1,study7Line,21.0,17,43,97,46,stackbar,set3,-3,3,False,1.6438561897747246,4,0,start0,aligned
1,study7Line,25.0,18,40,98,39,stackbar,set2,1,1,False,0.16992500144231237,11,1,non-aligned,non-aligned
1,study7Line,19.0,19,35,99,40,stackbar,set2,-5,5,False,2.357552004618084,10,1,non-aligned,non-aligned
1,study7Line,15.0,20,40,100,43,stackbar,set2,-3,3,False,1.6438561897747246,7,0,start0,aligned
1,study7Line,17.0,21,13,101,13,stackbar,set4,0,0,True,-3.0,12,6,non-aligned,non-aligned
1,study7Line,20.0,22,14,102,15,stackbar,set2,-1,1,False,0.16992500144231237,10,4,non-aligned,non-aligned
1,study7Line,16.0,23,21,103,22,stackbar,set1,-1,1,False,0.16992500144231237,3,2,non-aligned,non-aligned
1,study7Line,24.0,24,20,104,21,stackbar,set4,-1,1,False,0.16992500144231237,4,2,non-aligned,non-aligned
1,study7Line,28.0,25,45,105,44,stackbar,set1,1,1,False,0.16992500144231237,6,0,start0,aligned
1,study7Line,30.0,26,12,106,11,stackbar,set3,1,1,False,0.16992500144231237,11,5,non-aligned,non-aligned
1,study7Line,25.0,27,32,107,32,stackbar,set1,0,0,True,-3.0,7,2,non-aligned,non-aligned
1,study7Line,18.0,28,39,108,40,stackbar,set3,-1,1,False,0.16992500144231237,10,0,start0,aligned
1,study7Line,29.0,29,19,109,18,stackbar,set2,1,1,False,0.16992500144231237,7,1,non-aligned,non-aligned
1,study7Line,14.0,30,27,110,31,stackbar,set4,-4,4,False,2.0443941193584534,6,0,end50,aligned
1,study7Line,22.0,31,23,111,23,stackbar,set4,0,0,True,-3.0,2,0,start0,aligned
1,study7Line,16.0,32,39,112,43,stackbar,set3,-4,4,False,2.0443941193584534,7,3,non-aligned,non-aligned
1,study7Line,25.0,33,26,113,30,stackbar,set1,-4,4,False,2.0443941193584534,5,8,non-aligned,non-aligned
1,study7Line,33.0,34,31,114,45,stackbar,set2,-14,14,False,3.820178962415188,5,0,start0,aligned
1,study7Line,35.0,35,18,115,20,stackbar,set3,-2,2,False,1.0874628412503393,5,0,start0,aligned
1,study7Line,17.0,36,23,116,22,stackbar,set3,1,1,False,0.16992500144231237,3,0,start0,aligned
1,study7Line,15.0,37,16,117,19,stackbar,set1,-3,3,False,1.6438561897747246,6,8,non-aligned,non-aligned
1,study7Line,11.0,38,26,118,27,stackbar,set2,-1,1,False,0.16992500144231237,2,0,start0,aligned
1,study7Line,44.0,39,32,119,33,stackbar,set2,-1,1,False,0.16992500144231237,8,0,start0,aligned
1,study7Line,18.0,40,40,120,46,stackbar,set3,-6,6,False,2.6147098441152083,4,10,non-aligned,non-aligned
1,study7Line,34.0,41,34,121,35,stackbar,set1,-1,1,False,0.16992500144231237,10,0,start0,aligned
1,study7Line,185.0,42,27,122,30,stackbar,set3,-3,3,False,1.6438561897747246,5,0,start0,aligned
1,study7Line,9.0,43,30,123,17,stackbar,set3,13,13,False,3.7142455176661224,8,0,start0,aligned
1,study7Line,25.0,44,40,124,42,stackbar,set3,-2,2,False,1.0874628412503393,8,0,start0,aligned
1,study7Line,13.0,45,13,125,12,stackbar,set4,1,1,False,0.16992500144231237,12,6,non-aligned,non-aligned
1,study7Line,10.0,46,38,126,39,stackbar,set3,-1,1,False,0.16992500144231237,11,0,start0,aligned
1,study7Line,11.0,47,48,127,47,stackbar,set4,1,1,False,0.16992500144231237,3,0,start0,aligned
1,study7Line,7.0,48,29,128,34,stackbar,set3,-5,5,False,2.357552004618084,9,0,start0,aligned
1,study7Line,10.0,49,12,129,13,stackbar,set1,-1,1,False,0.16992500144231237,12,0,start0,aligned
1,study7Line,10.0,50,29,130,32,stackbar,set4,-3,3,False,1.6438561897747246,7,0,start0,aligned
1,study7Line,18.0,51,50,131,47,stackbar,set3,3,3,False,1.6438561897747246,3,10,non-aligned,non-aligned
1,study7Line,78.0,52,24,132,25,stackbar,set2,-1,1,False,0.16992500144231237,0,8,non-aligned,non-aligned
1,study7Line,36.0,53,26,133,26,stackbar,set2,0,0,True,-3.0,1,0,start0,aligned
1,study7Line,20.0,54,35,134,34,stackbar,set3,1,1,False,0.16992500144231237,9,3,non-aligned,non-aligned
1,study7Line,9.0,55,38,135,41,stackbar,set2,-3,3,False,1.6438561897747246,9,0,start0,aligned
1,study7Line,8.0,56,28,136,31,stackbar,set1,-3,3,False,1.6438561897747246,6,0,start0,aligned
1,study7Line,40.0,57,43,137,45,stackbar,set1,-2,2,False,1.0874628412503393,5,2,non-aligned,non-aligned
1,study7Line,14.0,58,11,138,11,stackbar,set4,0,0,True,-3.0,11,0,start0,aligned
1,study7Line,16.0,59,36,139,36,stackbar,set2,0,0,True,-3.0,11,0,start0,aligned
1,study7Line,21.0,60,43,140,44,stackbar,set1,-1,1,False,0.16992500144231237,6,2,non-aligned,non-aligned
1,study7Line,14.0,61,31,141,33,stackbar,set4,-2,2,False,1.0874628412503393,8,4,non-aligned,non-aligned
1,study7Line,14.0,62,39,142,41,stackbar,set3,-2,2,False,1.0874628412503393,9,1,non-aligned,non-aligned
1,study7Line,34.0,63,15,143,16,stackbar,set2,-1,1,False,0.16992500144231237,9,0,start0,aligned
1,study7Line,8.0,64,25,144,25,stackbar,set2,0,0,True,-3.0,0,0,start0,aligned
1,study7Line,14.0,65,40,145,42,stackbar,set3,-2,2,False,1.0874628412503393,8,7,non-aligned,non-aligned
1,study7Line,20.0,66,26,146,26,stackbar,set4,0,0,True,-3.0,1,1,non-aligned,non-aligned
1,study7Line,26.0,67,34,147,48,stackbar,set2,-14,14,False,3.820178962415188,2,2,non-aligned,non-aligned
1,study7Line,15.0,68,15,148,15,stackbar,set4,0,0,True,-3.0,10,0,start0,aligned
1,study7Line,13.0,69,35,149,35,stackbar,set4,0,0,True,-3.0,10,0,end100,aligned
1,study7Line,20.0,70,14,150,14,stackbar,set4,0,0,True,-3.0,11,0,start0,aligned
1,study7Line,11.0,71,37,151,37,stackbar,set4,0,0,True,-3.0,12,0,start0,aligned
1,study7Line,26.0,72,17,152,17,stackbar,set3,0,0,True,-3.0,8,3,non-aligned,non-aligned
1,study7Line,13.0,73,23,153,24,stackbar,set1,-1,1,False,0.16992500144231237,1,5,non-aligned,non-aligned
1,study7Line,11.0,74,23,154,23,stackbar,set1,0,0,True,-3.0,2,3,non-aligned,non-aligned
1,study7Line,8.0,75,49,155,49,stackbar,set4,0,0,True,-3.0,1,0,start0,aligned
1,study7Line,13.0,76,18,156,18,stackbar,set3,0,0,True,-3.0,7,0,start0,aligned
1,study7Line,14.0,77,19,157,19,stackbar,set3,0,0,True,-3.0,6,0,start0,aligned
1,study7Line,19.0,78,28,158,28,stackbar,set1,0,0,True,-3.0,3,0,start0,aligned
1,study7Line,11.0,79,49,159,49,stackbar,set3,0,0,True,-3.0,1,1,non-aligned,non-aligned
18,study7Line,144.0,0,30,1440,36,stackbar,set4,-6,6,False,2.6147098441152083,11,3,non-aligned,non-aligned
18,study7Line,16.0,1,14,1441,14,stackbar,set1,0,0,True,-3.0,11,0,start0,aligned
18,study7Line,30.0,2,40,1442,39,stackbar,set1,1,1,False,0.16992500144231237,11,0,start0,aligned
18,study7Line,25.0,3,40,1443,39,stackbar,set4,1,1,False,0.16992500144231237,11,1,non-aligned,non-aligned
18,study7Line,38.0,4,35,1444,36,stackbar,set2,-1,1,False,0.16992500144231237,11,0,start0,aligned
18,study7Line,12.0,5,15,1445,16,stackbar,set2,-1,1,False,0.16992500144231237,9,2,non-aligned,non-aligned
18,study7Line,37.0,6,33,1446,33,stackbar,set2,0,0,True,-3.0,8,0,start0,aligned
18,study7Line,24.0,7,40,1447,41,stackbar,set1,-1,1,False,0.16992500144231237,9,6,non-aligned,non-aligned
18,study7Line,25.0,8,12,1448,15,stackbar,set4,-3,3,False,1.6438561897747246,10,0,start0,aligned
18,study7Line,15.0,9,29,1449,29,stackbar,set4,0,0,True,-3.0,4,3,non-aligned,non-aligned
18,study7Line,13.0,10,45,1450,45,stackbar,set1,0,0,True,-3.0,5,2,non-aligned,non-aligned
18,study7Line,42.0,11,26,1451,26,stackbar,set3,0,0,True,-3.0,1,0,start0,aligned
18,study7Line,12.0,12,12,1452,12,stackbar,set1,0,0,True,-3.0,12,0,start0,aligned
18,study7Line,257.0,13,12,1453,14,stackbar,set1,-2,2,False,1.0874628412503393,11,5,non-aligned,non-aligned
18,study7Line,188.0,14,37,1454,34,stackbar,set4,3,3,False,1.6438561897747246,9,2,non-aligned,non-aligned
18,study7Line,19.0,15,12,1455,12,stackbar,set1,0,0,True,-3.0,12,1,non-aligned,non-aligned
18,study7Line,52.0,16,32,1456,32,stackbar,set2,0,0,True,-3.0,7,0,start0,aligned
18,study7Line,48.0,17,33,1457,32,stackbar,set2,1,1,False,0.16992500144231237,7,6,non-aligned,non-aligned
18,study7Line,21.0,18,20,1458,21,stackbar,set3,-1,1,False,0.16992500144231237,4,0,start0,aligned
18,study7Line,25.0,19,15,1459,16,stackbar,set3,-1,1,False,0.16992500144231237,9,0,start0,aligned
18,study7Line,25.0,20,16,1460,17,stackbar,set2,-1,1,False,0.16992500144231237,8,5,non-aligned,non-aligned
18,study7Line,14.0,21,25,1461,25,stackbar,set2,0,0,True,-3.0,0,8,non-aligned,non-aligned
18,study7Line,20.0,22,46,1462,46,stackbar,set2,0,0,True,-3.0,4,0,start0,aligned
18,study7Line,20.0,23,25,1463,25,stackbar,set3,0,0,True,-3.0,0,0,start0,aligned
18,study7Line,11.0,24,50,1464,50,stackbar,set3,0,0,True,-3.0,0,0,start0,aligned
18,study7Line,24.0,25,32,1465,33,stackbar,set4,-1,1,False,0.16992500144231237,8,4,non-aligned,non-aligned
18,study7Line,12.0,26,48,1466,47,stackbar,set1,1,1,False,0.16992500144231237,3,2,non-aligned,non-aligned
18,study7Line,17.0,27,37,1467,40,stackbar,set1,-3,3,False,1.6438561897747246,10,6,non-aligned,non-aligned
18,study7Line,13.0,28,40,1468,37,stackbar,set2,3,3,False,1.6438561897747246,12,5,non-aligned,non-aligned
18,study7Line,18.0,29,32,1469,31,stackbar,set1,1,1,False,0.16992500144231237,6,0,start0,aligned
18,study7Line,12.0,30,28,1470,27,stackbar,set1,1,1,False,0.16992500144231237,2,2,non-aligned,non-aligned
18,study7Line,14.0,31,45,1471,45,stackbar,set1,0,0,True,-3.0,5,0,start0,aligned
18,study7Line,11.0,32,47,1472,47,stackbar,set4,0,0,True,-3.0,3,0,start0,aligned
18,study7Line,16.0,33,15,1473,15,stackbar,set1,0,0,True,-3.0,10,5,non-aligned,non-aligned
18,study7Line,19.0,34,38,1474,38,stackbar,set2,0,0,True,-3.0,12,0,start0,aligned
18,study7Line,12.0,35,23,1475,22,stackbar,set4,1,1,False,0.16992500144231237,3,0,start75,aligned
18,study7Line,10.0,36,48,1476,48,stackbar,set3,0,0,True,-3.0,2,0,start0,aligned
18,study7Line,16.0,37,33,1477,34,stackbar,set1,-1,1,False,0.16992500144231237,9,0,start0,aligned
18,study7Line,11.0,38,35,1478,40,stackbar,set2,-5,5,False,2.357552004618084,10,0,start0,aligned
18,study7Line,11.0,39,33,1479,35,stackbar,set4,-2,2,False,1.0874628412503393,10,0,start0,aligned
18,study7Line,16.0,40,48,1480,46,stackbar,set1,2,2,False,1.0874628412503393,4,6,non-aligned,non-aligned
18,study7Line,11.0,41,48,1481,48,stackbar,set2,0,0,True,-3.0,2,2,non-aligned,non-aligned
18,study7Line,11.0,42,45,1482,43,stackbar,set1,2,2,False,1.0874628412503393,7,2,non-aligned,non-aligned
18,study7Line,11.0,43,35,1483,35,stackbar,set4,0,0,True,-3.0,10,0,end100,aligned
18,study7Line,67.0,44,47,1484,44,stackbar,set4,3,3,False,1.6438561897747246,6,0,start0,aligned
18,study7Line,9.0,45,30,1485,29,stackbar,set1,1,1,False,0.16992500144231237,4,0,start0,aligned
18,study7Line,16.0,46,22,1486,22,stackbar,set4,0,0,True,-3.0,3,0,start0,aligned
18,study7Line,9.0,47,18,1487,17,stackbar,set4,1,1,False,0.16992500144231237,8,0,start0,aligned
18,study7Line,71.0,48,13,1488,13,stackbar,set2,0,0,True,-3.0,12,6,non-aligned,non-aligned
18,study7Line,22.0,49,27,1489,27,stackbar,set4,0,0,True,-3.0,2,0,start0,aligned
18,study7Line,8.0,50,20,1490,21,stackbar,set1,-1,1,False,0.16992500144231237,4,1,non-aligned,non-aligned
18,study7Line,12.0,51,35,1491,41,stackbar,set4,-6,6,False,2.6147098441152083,9,0,start0,aligned
18,study7Line,12.0,52,45,1492,44,stackbar,set2,1,1,False,0.16992500144231237,6,9,non-aligned,non-aligned
18,study7Line,14.0,53,43,1493,42,stackbar,set4,1,1,False,0.16992500144231237,8,1,non-aligned,non-aligned
18,study7Line,14.0,54,20,1494,20,stackbar,set2,0,0,True,-3.0,5,0,start75,aligned
18,study7Line,16.0,55,28,1495,28,stackbar,set2,0,0,True,-3.0,3,8,non-aligned,non-aligned
18,study7Line,12.0,56,24,1496,23,stackbar,set2,1,1,False,0.16992500144231237,2,0,start0,aligned
18,study7Line,19.0,57,18,1497,19,stackbar,set4,-1,1,False,0.16992500144231237,6,0,start0,aligned
18,study7Line,18.0,58,42,1498,42,stackbar,set2,0,0,True,-3.0,8,0,start0,aligned
18,study7Line,9.0,59,50,1499,49,stackbar,set2,1,1,False,0.16992500144231237,1,8,non-aligned,non-aligned
18,study7Line,8.0,60,20,1500,20,stackbar,set3,0,0,True,-3.0,5,0,start0,aligned
18,study7Line,9.0,61,28,1501,28,stackbar,set4,0,0,True,-3.0,3,0,start0,aligned
18,study7Line,12.0,62,19,1502,18,stackbar,set4,1,1,False,0.16992500144231237,7,0,start0,aligned
18,study7Line,9.0,63,24,1503,23,stackbar,set2,1,1,False,0.16992500144231237,2,5,non-aligned,non-aligned
18,study7Line,12.0,64,10,1504,11,stackbar,set3,-1,1,False,0.16992500144231237,11,0,start0,aligned
18,study7Line,7.0,65,24,1505,24,stackbar,set4,0,0,True,-3.0,1,0,start0,aligned
18,study7Line,18.0,66,30,1506,30,stackbar,set2,0,0,True,-3.0,5,4,non-aligned,non-aligned
18,study7Line,8.0,67,10,1507,11,stackbar,set2,-1,1,False,0.16992500144231237,11,2,non-aligned,non-aligned
18,study7Line,10.0,68,45,1508,43,stackbar,set1,2,2,False,1.0874628412503393,7,0,start0,aligned
18,study7Line,9.0,69,20,1509,50,stackbar,set2,-30,30,False,4.912889336229962,0,4,non-aligned,non-aligned
18,study7Line,11.0,70,37,1510,37,stackbar,set4,0,0,True,-3.0,12,0,start0,aligned
18,study7Line,9.0,71,12,1511,13,stackbar,set4,-1,1,False,0.16992500144231237,12,0,start0,aligned
18,study7Line,8.0,72,25,1512,24,stackbar,set4,1,1,False,0.16992500144231237,1,9,non-aligned,non-aligned
18,study7Line,15.0,73,23,1513,26,stackbar,set2,-3,3,False,1.6438561897747246,1,10,non-aligned,non-aligned
18,study7Line,10.0,74,30,1514,30,stackbar,set4,0,0,True,-3.0,5,0,start0,aligned
18,study7Line,12.0,75,30,1515,31,stackbar,set1,-1,1,False,0.16992500144231237,6,4,non-aligned,non-aligned
18,study7Line,12.0,76,19,1516,18,stackbar,set4,1,1,False,0.16992500144231237,7,3,non-aligned,non-aligned
18,study7Line,12.0,77,18,1517,19,stackbar,set2,-1,1,False,0.16992500144231237,6,2,non-aligned,non-aligned
18,study7Line,14.0,78,38,1518,38,stackbar,set2,0,0,True,-3.0,12,5,non-aligned,non-aligned
18,study7Line,8.0,79,49,1519,49,stackbar,set1,0,0,True,-3.0,1,0,start0,aligned
29,study7Line,8.0,0,25,2320,24,stackbar,set3,1,1,False,0.16992500144231237,1,8,non-aligned,non-aligned
29,study7Line,8.0,1,17,2321,12,stackbar,set2,5,5,False,2.357552004618084,12,1,non-aligned,non-aligned
29,study7Line,6.0,2,45,2322,46,stackbar,set2,-1,1,False,0.16992500144231237,4,0,start0,aligned
29,study7Line,16.0,3,35,2323,39,stackbar,set3,-4,4,False,2.0443941193584534,11,3,non-aligned,non-aligned
29,study7Line,6.0,4,15,2324,22,stackbar,set2,-7,7,False,2.8328900141647417,3,9,non-aligned,non-aligned
29,study7Line,7.0,5,30,2325,33,stackbar,set4,-3,3,False,1.6438561897747246,8,4,non-aligned,non-aligned
29,study7Line,5.0,6,20,2326,19,stackbar,set1,1,1,False,0.16992500144231237,6,8,non-aligned,non-aligned
29,study7Line,6.0,7,23,2327,24,stackbar,set3,-1,1,False,0.16992500144231237,1,0,start0,aligned
29,study7Line,15.0,8,33,2328,31,stackbar,set3,2,2,False,1.0874628412503393,6,2,non-aligned,non-aligned
29,study7Line,5.0,9,20,2329,22,stackbar,set4,-2,2,False,1.0874628412503393,3,0,start0,aligned
29,study7Line,7.0,10,30,2330,30,stackbar,set2,0,0,True,-3.0,5,4,non-aligned,non-aligned
29,study7Line,13.0,11,18,2331,16,stackbar,set2,2,2,False,1.0874628412503393,9,2,non-aligned,non-aligned
29,study7Line,4.0,12,20,2332,20,stackbar,set2,0,0,True,-3.0,5,0,start0,aligned
29,study7Line,9.0,13,36,2333,37,stackbar,set3,-1,1,False,0.16992500144231237,12,0,start25,aligned
29,study7Line,7.0,14,47,2334,48,stackbar,set2,-1,1,False,0.16992500144231237,2,0,start0,aligned
29,study7Line,8.0,15,40,2335,42,stackbar,set2,-2,2,False,1.0874628412503393,8,0,start0,aligned
29,study7Line,6.0,16,22,2336,23,stackbar,set3,-1,1,False,0.16992500144231237,2,0,start0,aligned
29,study7Line,6.0,17,20,2337,20,stackbar,set2,0,0,True,-3.0,5,0,start75,aligned
29,study7Line,7.0,18,48,2338,47,stackbar,set2,1,1,False,0.16992500144231237,3,2,non-aligned,non-aligned
29,study7Line,5.0,19,32,2339,30,stackbar,set2,2,2,False,1.0874628412503393,5,0,start0,aligned
29,study7Line,9.0,20,15,2340,17,stackbar,set1,-2,2,False,1.0874628412503393,8,0,start0,aligned
29,study7Line,13.0,21,40,2341,44,stackbar,set3,-4,4,False,2.0443941193584534,6,8,non-aligned,non-aligned
29,study7Line,11.0,22,37,2342,37,stackbar,set4,0,0,True,-3.0,12,0,start0,aligned
29,study7Line,9.0,23,15,2343,16,stackbar,set1,-1,1,False,0.16992500144231237,9,0,start0,aligned
29,study7Line,13.0,24,40,2344,38,stackbar,set1,2,2,False,1.0874628412503393,12,1,non-aligned,non-aligned
29,study7Line,30.0,25,40,2345,41,stackbar,set2,-1,1,False,0.16992500144231237,9,4,non-aligned,non-aligned
29,study7Line,5.0,26,40,2346,36,stackbar,set3,4,4,False,2.0443941193584534,11,3,non-aligned,non-aligned
29,study7Line,5.0,27,25,2347,26,stackbar,set2,-1,1,False,0.16992500144231237,1,10,non-aligned,non-aligned
29,study7Line,5.0,28,40,2348,43,stackbar,set3,-3,3,False,1.6438561897747246,7,0,start0,aligned
29,study7Line,8.0,29,50,2349,49,stackbar,set2,1,1,False,0.16992500144231237,1,8,non-aligned,non-aligned
29,study7Line,7.0,30,37,2350,38,stackbar,set4,-1,1,False,0.16992500144231237,12,0,start0,aligned
29,study7Line,8.0,31,28,2351,28,stackbar,set4,0,0,True,-3.0,3,0,start0,aligned
29,study7Line,9.0,32,40,2352,40,stackbar,set3,0,0,True,-3.0,10,2,non-aligned,non-aligned
29,study7Line,9.0,33,30,2353,29,stackbar,set1,1,1,False,0.16992500144231237,4,2,non-aligned,non-aligned
29,study7Line,6.0,34,35,2354,33,stackbar,set4,2,2,False,1.0874628412503393,8,0,start0,aligned
29,study7Line,9.0,35,48,2355,46,stackbar,set2,2,2,False,1.0874628412503393,4,9,non-aligned,non-aligned
29,study7Line,5.0,36,45,2356,45,stackbar,set3,0,0,True,-3.0,5,0,start0,aligned
29,study7Line,6.0,37,48,2357,49,stackbar,set4,-1,1,False,0.16992500144231237,1,0,start0,aligned
29,study7Line,8.0,38,18,2358,19,stackbar,set4,-1,1,False,0.16992500144231237,6,0,start0,aligned
29,study7Line,7.0,39,27,2359,26,stackbar,set3,1,1,False,0.16992500144231237,1,0,start0,aligned
29,study7Line,6.0,40,50,2360,50,stackbar,set2,0,0,True,-3.0,0,4,non-aligned,non-aligned
29,study7Line,12.0,41,35,2361,35,stackbar,set1,0,0,True,-3.0,10,6,non-aligned,non-aligned
29,study7Line,6.0,42,12,2362,12,stackbar,set3,0,0,True,-3.0,12,0,start0,aligned
29,study7Line,4.0,43,45,2363,47,stackbar,set4,-2,2,False,1.0874628412503393,3,0,start0,aligned
29,study7Line,4.0,44,12,2364,15,stackbar,set1,-3,3,False,1.6438561897747246,10,0,start0,aligned
29,study7Line,6.0,45,50,2365,50,stackbar,set4,0,0,True,-3.0,0,0,start0,aligned
29,study7Line,4.0,46,30,2366,29,stackbar,set1,1,1,False,0.16992500144231237,4,0,start0,aligned
29,study7Line,5.0,47,30,2367,28,stackbar,set2,2,2,False,1.0874628412503393,3,8,non-aligned,non-aligned
29,study7Line,9.0,48,40,2368,43,stackbar,set1,-3,3,False,1.6438561897747246,7,2,non-aligned,non-aligned
29,study7Line,5.0,49,40,2369,40,stackbar,set1,0,0,True,-3.0,10,0,start0,aligned
29,study7Line,6.0,50,30,2370,32,stackbar,set4,-2,2,False,1.0874628412503393,7,7,non-aligned,non-aligned
29,study7Line,5.0,51,20,2371,21,stackbar,set4,-1,1,False,0.16992500144231237,4,0,start0,aligned
29,study7Line,9.0,52,15,2372,15,stackbar,set1,0,0,True,-3.0,10,5,non-aligned,non-aligned
29,study7Line,5.0,53,20,2373,21,stackbar,set4,-1,1,False,0.16992500144231237,4,2,non-aligned,non-aligned
29,study7Line,5.0,54,25,2374,25,stackbar,set3,0,0,True,-3.0,0,0,start0,aligned
29,study7Line,7.0,55,50,2375,48,stackbar,set1,2,2,False,1.0874628412503393,2,9,non-aligned,non-aligned
29,study7Line,6.0,56,35,2376,35,stackbar,set2,0,0,True,-3.0,10,0,start0,aligned
29,study7Line,5.0,57,30,2377,27,stackbar,set3,3,3,False,1.6438561897747246,2,6,non-aligned,non-aligned
29,study7Line,8.0,58,17,2378,18,stackbar,set3,-1,1,False,0.16992500144231237,7,0,start0,aligned
29,study7Line,7.0,59,45,2379,44,stackbar,set3,1,1,False,0.16992500144231237,6,0,start0,aligned
29,study7Line,5.0,60,25,2380,25,stackbar,set1,0,0,True,-3.0,0,7,non-aligned,non-aligned
29,study7Line,4.0,61,25,2381,23,stackbar,set2,2,2,False,1.0874628412503393,2,5,non-aligned,non-aligned
29,study7Line,4.0,62,37,2382,39,stackbar,set2,-2,2,False,1.0874628412503393,11,0,start0,aligned
29,study7Line,8.0,63,40,2383,41,stackbar,set1,-1,1,False,0.16992500144231237,9,0,start0,aligned
29,study7Line,9.0,64,13,2384,13,stackbar,set1,0,0,True,-3.0,12,6,non-aligned,non-aligned
29,study7Line,10.0,65,33,2385,32,stackbar,set4,1,1,False,0.16992500144231237,7,0,start0,aligned
29,study7Line,7.0,66,15,2386,14,stackbar,set1,1,1,False,0.16992500144231237,11,5,non-aligned,non-aligned
29,study7Line,7.0,67,45,2387,45,stackbar,set1,0,0,True,-3.0,5,2,non-aligned,non-aligned
29,study7Line,6.0,68,15,2388,17,stackbar,set3,-2,2,False,1.0874628412503393,8,3,non-aligned,non-aligned
29,study7Line,13.0,69,10,2389,11,stackbar,set1,-1,1,False,0.16992500144231237,11,4,non-aligned,non-aligned
29,study7Line,5.0,70,35,2390,34,stackbar,set4,1,1,False,0.16992500144231237,9,0,start0,aligned
29,study7Line,8.0,71,18,2391,18,stackbar,set1,0,0,True,-3.0,7,1,non-aligned,non-aligned
29,study7Line,4.0,72,12,2392,13,stackbar,set4,-1,1,False,0.16992500144231237,12,0,start0,aligned
29,study7Line,5.0,73,40,2393,42,stackbar,set1,-2,2,False,1.0874628412503393,8,3,non-aligned,non-aligned
29,study7Line,7.0,74,10,2394,11,stackbar,set1,-1,1,False,0.16992500144231237,11,0,start0,aligned
29,study7Line,5.0,75,35,2395,36,stackbar,set3,-1,1,False,0.16992500144231237,11,0,start0,aligned
29,study7Line,7.0,76,28,2396,27,stackbar,set3,1,1,False,0.16992500144231237,2,0,start0,aligned
29,study7Line,5.0,77,13,2397,14,stackbar,set3,-1,1,False,0.16992500144231237,11,0,start0,aligned
29,study7Line,7.0,78,30,2398,31,stackbar,set3,-1,1,False,0.16992500144231237,6,0,start0,aligned
29,study7Line,8.0,79,33,2399,34,stackbar,set2,-1,1,False,0.16992500144231237,9,2,non-aligned,non-aligned
35,study7Line,13.0,0,27,2800,28,stackbar,set4,-1,1,False,0.16992500144231237,3,0,start0,aligned
35,study7Line,15.0,1,32,2801,36,stackbar,set1,-4,4,False,2.0443941193584534,11,3,non-aligned,non-aligned
35,study7Line,9.0,2,25,2802,25,stackbar,set1,0,0,True,-3.0,0,7,non-aligned,non-aligned
35,study7Line,8.0,3,40,2803,42,stackbar,set3,-2,2,False,1.0874628412503393,8,0,start0,aligned
35,study7Line,14.0,4,40,2804,35,stackbar,set2,5,5,False,2.357552004618084,10,3,non-aligned,non-aligned
35,study7Line,9.0,5,48,2805,48,stackbar,set2,0,0,True,-3.0,2,0,start0,aligned
35,study7Line,9.0,6,65,2806,42,stackbar,set1,23,23,False,4.531381460516312,8,3,non-aligned,non-aligned
35,study7Line,8.0,7,24,2807,24,stackbar,set4,0,0,True,-3.0,1,0,start0,aligned
35,study7Line,7.0,8,40,2808,45,stackbar,set4,-5,5,False,2.357552004618084,5,0,start0,aligned
35,study7Line,17.0,9,48,2809,45,stackbar,set2,3,3,False,1.6438561897747246,5,9,non-aligned,non-aligned
35,study7Line,9.0,10,23,2810,23,stackbar,set3,0,0,True,-3.0,2,0,start0,aligned
35,study7Line,10.0,11,45,2811,47,stackbar,set1,-2,2,False,1.0874628412503393,3,2,non-aligned,non-aligned
35,study7Line,10.0,12,30,2812,28,stackbar,set2,2,2,False,1.0874628412503393,3,8,non-aligned,non-aligned
35,study7Line,7.0,13,20,2813,20,stackbar,set2,0,0,True,-3.0,5,0,start0,aligned
35,study7Line,5.0,14,49,2814,49,stackbar,set4,0,0,True,-3.0,1,0,start0,aligned
35,study7Line,10.0,15,19,2815,19,stackbar,set1,0,0,True,-3.0,6,8,non-aligned,non-aligned
35,study7Line,14.0,16,35,2816,34,stackbar,set1,1,1,False,0.16992500144231237,9,6,non-aligned,non-aligned
35,study7Line,7.0,17,15,2817,16,stackbar,set2,-1,1,False,0.16992500144231237,9,0,start0,aligned
35,study7Line,13.0,18,19,2818,17,stackbar,set4,2,2,False,1.0874628412503393,8,1,non-aligned,non-aligned
35,study7Line,9.0,19,30,2819,27,stackbar,set4,3,3,False,1.6438561897747246,2,3,non-aligned,non-aligned
35,study7Line,21.0,20,42,2820,44,stackbar,set3,-2,2,False,1.0874628412503393,6,8,non-aligned,non-aligned
35,study7Line,7.0,21,12,2821,14,stackbar,set1,-2,2,False,1.0874628412503393,11,0,start0,aligned
35,study7Line,10.0,22,35,2822,30,stackbar,set3,5,5,False,2.357552004618084,5,7,non-aligned,non-aligned
35,study7Line,9.0,23,18,2823,18,stackbar,set3,0,0,True,-3.0,7,2,non-aligned,non-aligned
35,study7Line,10.0,24,35,2824,34,stackbar,set4,1,1,False,0.16992500144231237,9,0,start0,aligned
35,study7Line,7.0,25,30,2825,31,stackbar,set2,-1,1,False,0.16992500144231237,6,0,start0,aligned
35,study7Line,5.0,26,30,2826,30,stackbar,set2,0,0,True,-3.0,5,0,start0,aligned
35,study7Line,19.0,27,35,2827,33,stackbar,set2,2,2,False,1.0874628412503393,8,8,non-aligned,non-aligned
35,study7Line,8.0,28,35,2828,32,stackbar,set1,3,3,False,1.6438561897747246,7,0,start0,aligned
35,study7Line,18.0,29,38,2829,38,stackbar,set4,0,0,True,-3.0,12,0,start0,aligned
35,study7Line,9.0,30,12,2830,13,stackbar,set2,-1,1,False,0.16992500144231237,12,0,start0,aligned
35,study7Line,11.0,31,40,2831,37,stackbar,set1,3,3,False,1.6438561897747246,12,6,non-aligned,non-aligned
35,study7Line,9.0,32,12,2832,13,stackbar,set1,-1,1,False,0.16992500144231237,12,6,non-aligned,non-aligned
35,study7Line,7.0,33,50,2833,46,stackbar,set2,4,4,False,2.0443941193584534,4,9,non-aligned,non-aligned
35,study7Line,10.0,34,39,2834,40,stackbar,set3,-1,1,False,0.16992500144231237,10,0,start0,aligned
35,study7Line,8.0,35,30,2835,29,stackbar,set4,1,1,False,0.16992500144231237,4,3,non-aligned,non-aligned
35,study7Line,8.0,36,37,2836,36,stackbar,set1,1,1,False,0.16992500144231237,11,0,start0,aligned
35,study7Line,5.0,37,50,2837,50,stackbar,set3,0,0,True,-3.0,0,0,start0,aligned
35,study7Line,7.0,38,30,2838,31,stackbar,set3,-1,1,False,0.16992500144231237,6,2,non-aligned,non-aligned
35,study7Line,7.0,39,25,2839,24,stackbar,set3,1,1,False,0.16992500144231237,1,8,non-aligned,non-aligned
35,study7Line,10.0,40,10,2840,12,stackbar,set4,-2,2,False,1.0874628412503393,12,6,non-aligned,non-aligned
35,study7Line,10.0,41,17,2841,15,stackbar,set2,2,2,False,1.0874628412503393,10,0,start0,aligned
35,study7Line,8.0,42,22,2842,22,stackbar,set1,0,0,True,-3.0,3,2,non-aligned,non-aligned
35,study7Line,15.0,43,23,2843,21,stackbar,set2,2,2,False,1.0874628412503393,4,6,non-aligned,non-aligned
35,study7Line,12.0,44,38,2844,40,stackbar,set2,-2,2,False,1.0874628412503393,10,1,non-aligned,non-aligned
35,study7Line,9.0,45,10,2845,11,stackbar,set1,-1,1,False,0.16992500144231237,11,4,non-aligned,non-aligned
35,study7Line,8.0,46,32,2846,35,stackbar,set3,-3,3,False,1.6438561897747246,10,0,start0,aligned
35,study7Line,6.0,47,50,2847,50,stackbar,set3,0,0,True,-3.0,0,5,non-aligned,non-aligned
35,study7Line,8.0,48,50,2848,49,stackbar,set1,1,1,False,0.16992500144231237,1,8,non-aligned,non-aligned
35,study7Line,9.0,49,42,2849,44,stackbar,set4,-2,2,False,1.0874628412503393,6,0,start0,aligned
35,study7Line,6.0,50,22,2850,22,stackbar,set1,0,0,True,-3.0,3,0,start0,aligned
35,study7Line,8.0,51,35,2851,33,stackbar,set3,2,2,False,1.0874628412503393,8,0,start0,aligned
35,study7Line,11.0,52,37,2852,38,stackbar,set4,-1,1,False,0.16992500144231237,12,6,non-aligned,non-aligned
35,study7Line,5.0,53,25,2853,25,stackbar,set3,0,0,True,-3.0,0,0,start0,aligned
35,study7Line,9.0,54,21,2854,20,stackbar,set3,1,1,False,0.16992500144231237,5,2,non-aligned,non-aligned
35,study7Line,9.0,55,38,2855,39,stackbar,set4,-1,1,False,0.16992500144231237,11,1,non-aligned,non-aligned
35,study7Line,6.0,56,12,2856,15,stackbar,set3,-3,3,False,1.6438561897747246,10,3,non-aligned,non-aligned
35,study7Line,7.0,57,40,2857,41,stackbar,set1,-1,1,False,0.16992500144231237,9,0,start0,aligned
35,study7Line,9.0,58,9,2858,12,stackbar,set3,-3,3,False,1.6438561897747246,12,0,start0,aligned
35,study7Line,10.0,59,18,2859,19,stackbar,set3,-1,1,False,0.16992500144231237,6,0,start0,aligned
35,study7Line,12.0,60,15,2860,14,stackbar,set1,1,1,False,0.16992500144231237,11,5,non-aligned,non-aligned
35,study7Line,8.0,61,48,2861,48,stackbar,set1,0,0,True,-3.0,2,9,non-aligned,non-aligned
35,study7Line,8.0,62,41,2862,43,stackbar,set3,-2,2,False,1.0874628412503393,7,0,start0,aligned
35,study7Line,5.0,63,26,2863,26,stackbar,set2,0,0,True,-3.0,1,0,start0,aligned
35,study7Line,7.0,64,9,2864,11,stackbar,set4,-2,2,False,1.0874628412503393,11,0,start0,aligned
35,study7Line,8.0,65,32,2865,32,stackbar,set4,0,0,True,-3.0,7,7,non-aligned,non-aligned
35,study7Line,6.0,66,25,2866,26,stackbar,set2,-1,1,False,0.16992500144231237,1,10,non-aligned,non-aligned
35,study7Line,7.0,67,39,2867,39,stackbar,set4,0,0,True,-3.0,11,0,start0,aligned
35,study7Line,6.0,68,18,2868,16,stackbar,set2,2,2,False,1.0874628412503393,9,2,non-aligned,non-aligned
35,study7Line,11.0,69,23,2869,23,stackbar,set1,0,0,True,-3.0,2,3,non-aligned,non-aligned
35,study7Line,7.0,70,35,2870,37,stackbar,set1,-2,2,False,1.0874628412503393,12,0,start0,aligned
35,study7Line,9.0,71,15,2871,17,stackbar,set3,-2,2,False,1.0874628412503393,8,0,start0,aligned
35,study7Line,15.0,72,42,2872,41,stackbar,set1,1,1,False,0.16992500144231237,9,6,non-aligned,non-aligned
35,study7Line,11.0,73,47,2873,47,stackbar,set3,0,0,True,-3.0,3,0,start0,aligned
35,study7Line,5.0,74,47,2874,46,stackbar,set1,1,1,False,0.16992500144231237,4,0,start0,aligned
35,study7Line,6.0,75,30,2875,29,stackbar,set2,1,1,False,0.16992500144231237,4,0,start0,aligned
35,study7Line,6.0,76,27,2876,27,stackbar,set3,0,0,True,-3.0,2,0,start0,aligned
35,study7Line,15.0,77,18,2877,18,stackbar,set2,0,0,True,-3.0,7,0,start0,aligned
35,study7Line,9.0,78,40,2878,43,stackbar,set3,-3,3,False,1.6438561897747246,7,3,non-aligned,non-aligned
35,study7Line,7.0,79,21,2879,21,stackbar,set3,0,0,True,-3.0,4,0,start0,aligned
6,study7Line,12.0,0,25,480,27,stackbar,set2,-2,2,False,1.0874628412503393,2,11,non-aligned,non-aligned
6,study7Line,8.0,1,25,481,28,stackbar,set1,-3,3,False,1.6438561897747246,3,10,non-aligned,non-aligned
6,study7Line,7.0,2,10,482,12,stackbar,set1,-2,2,False,1.0874628412503393,12,1,non-aligned,non-aligned
6,study7Line,8.0,3,50,483,46,stackbar,set3,4,4,False,2.0443941193584534,4,10,non-aligned,non-aligned
6,study7Line,10.0,4,35,484,39,stackbar,set4,-4,4,False,2.0443941193584534,11,0,start0,aligned
6,study7Line,6.0,5,30,485,41,stackbar,set4,-11,11,False,3.4757334309663976,9,4,non-aligned,non-aligned
6,study7Line,8.0,6,40,486,41,stackbar,set1,-1,1,False,0.16992500144231237,9,0,start0,aligned
6,study7Line,5.0,7,10,487,11,stackbar,set2,-1,1,False,0.16992500144231237,11,2,non-aligned,non-aligned
6,study7Line,7.0,8,45,488,43,stackbar,set2,2,2,False,1.0874628412503393,7,0,start0,aligned
6,study7Line,10.0,9,50,489,47,stackbar,set2,3,3,False,1.6438561897747246,3,2,non-aligned,non-aligned
6,study7Line,9.0,10,25,490,20,stackbar,set2,5,5,False,2.357552004618084,5,0,start75,aligned
6,study7Line,8.0,11,35,491,39,stackbar,set1,-4,4,False,2.0443941193584534,11,4,non-aligned,non-aligned
6,study7Line,6.0,12,30,492,32,stackbar,set3,-2,2,False,1.0874628412503393,7,2,non-aligned,non-aligned
6,study7Line,9.0,13,20,493,16,stackbar,set1,4,4,False,2.0443941193584534,9,1,non-aligned,non-aligned
6,study7Line,5.0,14,23,494,23,stackbar,set3,0,0,True,-3.0,2,0,start0,aligned
6,study7Line,8.0,15,50,495,49,stackbar,set3,1,1,False,0.16992500144231237,1,1,non-aligned,non-aligned
6,study7Line,7.0,16,28,496,38,stackbar,set4,-10,10,False,3.3398500028846247,12,6,non-aligned,non-aligned
6,study7Line,6.0,17,25,497,26,stackbar,set1,-1,1,False,0.16992500144231237,1,3,non-aligned,non-aligned
6,study7Line,6.0,18,15,498,14,stackbar,set4,1,1,False,0.16992500144231237,11,6,non-aligned,non-aligned
6,study7Line,6.0,19,50,499,48,stackbar,set4,2,2,False,1.0874628412503393,2,2,non-aligned,non-aligned
6,study7Line,6.0,20,25,500,23,stackbar,set2,2,2,False,1.0874628412503393,2,5,non-aligned,non-aligned
6,study7Line,7.0,21,15,501,15,stackbar,set1,0,0,True,-3.0,10,0,start0,aligned
6,study7Line,14.0,22,13,502,13,stackbar,set1,0,0,True,-3.0,12,0,start0,aligned
6,study7Line,8.0,23,30,503,34,stackbar,set1,-4,4,False,2.0443941193584534,9,0,start0,aligned
6,study7Line,9.0,24,50,504,50,stackbar,set1,0,0,True,-3.0,0,6,non-aligned,non-aligned
6,study7Line,6.0,25,30,505,31,stackbar,set4,-1,1,False,0.16992500144231237,6,0,start0,aligned
6,study7Line,11.0,26,30,506,34,stackbar,set2,-4,4,False,2.0443941193584534,9,2,non-aligned,non-aligned
6,study7Line,7.0,27,30,507,33,stackbar,set2,-3,3,False,1.6438561897747246,8,8,non-aligned,non-aligned
6,study7Line,6.0,28,30,508,30,stackbar,set3,0,0,True,-3.0,5,7,non-aligned,non-aligned
6,study7Line,7.0,29,20,509,18,stackbar,set3,2,2,False,1.0874628412503393,7,0,start0,aligned
6,study7Line,7.0,30,40,510,37,stackbar,set4,3,3,False,1.6438561897747246,12,1,non-aligned,non-aligned
6,study7Line,7.0,31,49,511,49,stackbar,set4,0,0,True,-3.0,1,0,start0,aligned
6,study7Line,7.0,32,38,512,42,stackbar,set1,-4,4,False,2.0443941193584534,8,0,start0,aligned
6,study7Line,6.0,33,40,513,44,stackbar,set2,-4,4,False,2.0443941193584534,6,0,start0,aligned
6,study7Line,5.0,34,27,514,28,stackbar,set4,-1,1,False,0.16992500144231237,3,0,start0,aligned
6,study7Line,8.0,35,20,515,19,stackbar,set3,1,1,False,0.16992500144231237,6,1,non-aligned,non-aligned
6,study7Line,6.0,36,25,516,31,stackbar,set4,-6,6,False,2.6147098441152083,6,0,end50,aligned
6,study7Line,11.0,37,19,517,18,stackbar,set3,1,1,False,0.16992500144231237,7,2,non-aligned,non-aligned
6,study7Line,7.0,38,10,518,13,stackbar,set1,-3,3,False,1.6438561897747246,12,6,non-aligned,non-aligned
6,study7Line,12.0,39,35,519,44,stackbar,set2,-9,9,False,3.189824558880017,6,9,non-aligned,non-aligned
6,study7Line,8.0,40,25,520,24,stackbar,set1,1,1,False,0.16992500144231237,1,5,non-aligned,non-aligned
6,study7Line,5.0,41,25,521,25,stackbar,set3,0,0,True,-3.0,0,0,start0,aligned
6,study7Line,6.0,42,30,522,33,stackbar,set4,-3,3,False,1.6438561897747246,8,0,start0,aligned
6,study7Line,5.0,43,20,523,21,stackbar,set3,-1,1,False,0.16992500144231237,4,0,start0,aligned
6,study7Line,6.0,44,20,524,21,stackbar,set1,-1,1,False,0.16992500144231237,4,1,non-aligned,non-aligned
6,study7Line,12.0,45,17,525,17,stackbar,set2,0,0,True,-3.0,8,0,start0,aligned
6,study7Line,8.0,46,30,526,36,stackbar,set3,-6,6,False,2.6147098441152083,11,0,start0,aligned
6,study7Line,9.0,47,28,527,30,stackbar,set2,-2,2,False,1.0874628412503393,5,0,start0,aligned
6,study7Line,7.0,48,30,528,37,stackbar,set3,-7,7,False,2.8328900141647417,12,0,start0,aligned
6,study7Line,7.0,49,25,529,29,stackbar,set4,-4,4,False,2.0443941193584534,4,3,non-aligned,non-aligned
6,study7Line,6.0,50,20,530,19,stackbar,set4,1,1,False,0.16992500144231237,6,0,start0,aligned
6,study7Line,10.0,51,20,531,22,stackbar,set4,-2,2,False,1.0874628412503393,3,0,start75,aligned
6,study7Line,6.0,52,30,532,32,stackbar,set2,-2,2,False,1.0874628412503393,7,0,start0,aligned
6,study7Line,8.0,53,15,533,16,stackbar,set2,-1,1,False,0.16992500144231237,9,0,start0,aligned
6,study7Line,13.0,54,25,534,25,stackbar,set4,0,0,True,-3.0,0,0,start25,aligned
6,study7Line,9.0,55,22,535,22,stackbar,set1,0,0,True,-3.0,3,0,start0,aligned
6,study7Line,7.0,56,35,536,38,stackbar,set1,-3,3,False,1.6438561897747246,12,0,start0,aligned
6,study7Line,8.0,57,50,537,42,stackbar,set3,8,8,False,3.0223678130284544,8,7,non-aligned,non-aligned
6,study7Line,8.0,58,45,538,45,stackbar,set2,0,0,True,-3.0,5,0,start0,aligned
6,study7Line,16.0,59,30,539,35,stackbar,set3,-5,5,False,2.357552004618084,10,2,non-aligned,non-aligned
6,study7Line,5.0,60,50,540,50,stackbar,set2,0,0,True,-3.0,0,0,start0,aligned
6,study7Line,5.0,61,20,541,20,stackbar,set1,0,0,True,-3.0,5,0,start0,aligned
6,study7Line,12.0,62,24,542,24,stackbar,set4,0,0,True,-3.0,1,0,start0,aligned
6,study7Line,9.0,63,40,543,40,stackbar,set3,0,0,True,-3.0,10,2,non-aligned,non-aligned
6,study7Line,6.0,64,45,544,46,stackbar,set4,-1,1,False,0.16992500144231237,4,0,start0,aligned
6,study7Line,7.0,65,10,545,12,stackbar,set1,-2,2,False,1.0874628412503393,12,0,start0,aligned
6,study7Line,8.0,66,28,546,27,stackbar,set1,1,1,False,0.16992500144231237,2,0,start0,aligned
6,study7Line,7.0,67,15,547,15,stackbar,set1,0,0,True,-3.0,10,5,non-aligned,non-aligned
6,study7Line,6.0,68,45,548,48,stackbar,set2,-3,3,False,1.6438561897747246,2,0,start0,aligned
6,study7Line,5.0,69,27,549,29,stackbar,set4,-2,2,False,1.0874628412503393,4,0,start0,aligned
6,study7Line,4.0,70,50,550,45,stackbar,set1,5,5,False,2.357552004618084,5,2,non-aligned,non-aligned
6,study7Line,7.0,71,10,551,11,stackbar,set3,-1,1,False,0.16992500144231237,11,0,start0,aligned
6,study7Line,17.0,72,13,552,14,stackbar,set3,-1,1,False,0.16992500144231237,11,0,start0,aligned
6,study7Line,12.0,73,20,553,17,stackbar,set2,3,3,False,1.6438561897747246,8,5,non-aligned,non-aligned
6,study7Line,4.0,74,26,554,26,stackbar,set1,0,0,True,-3.0,1,0,start0,aligned
6,study7Line,8.0,75,50,555,43,stackbar,set4,7,7,False,2.8328900141647417,7,6,non-aligned,non-aligned
6,study7Line,6.0,76,47,556,47,stackbar,set3,0,0,True,-3.0,3,0,start0,aligned
6,study7Line,10.0,77,30,557,35,stackbar,set4,-5,5,False,2.357552004618084,10,0,start0,aligned
6,study7Line,8.0,78,40,558,36,stackbar,set2,4,4,False,2.0443941193584534,11,1,non-aligned,non-aligned
6,study7Line,6.0,79,35,559,40,stackbar,set1,-5,5,False,2.357552004618084,10,0,start0,aligned
20,study7Line,8.0,0,50,1600,50,stackbar,set4,0,0,True,-3.0,0,0,start0,aligned
20,study7Line,9.0,1,27,1601,27,stackbar,set1,0,0,True,-3.0,2,0,start0,aligned
20,study7Line,20.0,2,35,1602,37,stackbar,set4,-2,2,False,1.0874628412503393,12,0,start0,aligned
20,study7Line,10.0,3,30,1603,33,stackbar,set3,-3,3,False,1.6438561897747246,8,0,start0,aligned
20,study7Line,9.0,4,40,1604,42,stackbar,set1,-2,2,False,1.0874628412503393,8,0,start0,aligned
20,study7Line,8.0,5,25,1605,24,stackbar,set3,1,1,False,0.16992500144231237,1,8,non-aligned,non-aligned
20,study7Line,6.0,6,10,1606,14,stackbar,set1,-4,4,False,2.0443941193584534,11,5,non-aligned,non-aligned
20,study7Line,10.0,7,15,1607,16,stackbar,set1,-1,1,False,0.16992500144231237,9,1,non-aligned,non-aligned
20,study7Line,7.0,8,50,1608,46,stackbar,set4,4,4,False,2.0443941193584534,4,2,non-aligned,non-aligned
20,study7Line,9.0,9,50,1609,41,stackbar,set1,9,9,False,3.189824558880017,9,6,non-aligned,non-aligned
20,study7Line,6.0,10,55,1610,50,stackbar,set1,5,5,False,2.357552004618084,0,6,non-aligned,non-aligned
20,study7Line,7.0,11,20,1611,19,stackbar,set4,1,1,False,0.16992500144231237,6,0,end75,aligned
20,study7Line,9.0,12,30,1612,31,stackbar,set2,-1,1,False,0.16992500144231237,6,0,start0,aligned
20,study7Line,5.0,13,45,1613,46,stackbar,set4,-1,1,False,0.16992500144231237,4,0,start0,aligned
20,study7Line,15.0,14,35,1614,36,stackbar,set2,-1,1,False,0.16992500144231237,11,1,non-aligned,non-aligned
20,study7Line,6.0,15,25,1615,29,stackbar,set3,-4,4,False,2.0443941193584534,4,9,non-aligned,non-aligned
20,study7Line,6.0,16,27,1616,26,stackbar,set3,1,1,False,0.16992500144231237,1,0,start0,aligned
20,study7Line,5.0,17,32,1617,34,stackbar,set4,-2,2,False,1.0874628412503393,9,0,start0,aligned
20,study7Line,5.0,18,22,1618,23,stackbar,set2,-1,1,False,0.16992500144231237,2,0,start0,aligned
20,study7Line,6.0,19,47,1619,47,stackbar,set2,0,0,True,-3.0,3,0,start0,aligned
20,study7Line,6.0,20,34,1620,35,stackbar,set3,-1,1,False,0.16992500144231237,10,0,start0,aligned
20,study7Line,7.0,21,25,1621,22,stackbar,set1,3,3,False,1.6438561897747246,3,2,non-aligned,non-aligned
20,study7Line,5.0,22,20,1622,18,stackbar,set1,2,2,False,1.0874628412503393,7,1,non-aligned,non-aligned
20,study7Line,9.0,23,13,1623,13,stackbar,set2,0,0,True,-3.0,12,0,start0,aligned
20,study7Line,8.0,24,33,1624,36,stackbar,set4,-3,3,False,1.6438561897747246,11,0,start0,aligned
20,study7Line,6.0,25,30,1625,29,stackbar,set2,1,1,False,0.16992500144231237,4,0,start0,aligned
20,study7Line,6.0,26,48,1626,49,stackbar,set4,-1,1,False,0.16992500144231237,1,0,start0,aligned
20,study7Line,16.0,27,40,1627,38,stackbar,set4,2,2,False,1.0874628412503393,12,0,start0,aligned
20,study7Line,4.0,28,25,1628,27,stackbar,set3,-2,2,False,1.0874628412503393,2,6,non-aligned,non-aligned
20,study7Line,6.0,29,25,1629,30,stackbar,set1,-5,5,False,2.357552004618084,5,8,non-aligned,non-aligned
20,study7Line,5.0,30,15,1630,13,stackbar,set2,2,2,False,1.0874628412503393,12,6,non-aligned,non-aligned
20,study7Line,5.0,31,13,1631,14,stackbar,set2,-1,1,False,0.16992500144231237,11,0,start0,aligned
20,study7Line,5.0,32,40,1632,39,stackbar,set2,1,1,False,0.16992500144231237,11,0,start0,aligned
20,study7Line,6.0,33,50,1633,48,stackbar,set4,2,2,False,1.0874628412503393,2,2,non-aligned,non-aligned
20,study7Line,6.0,34,45,1634,44,stackbar,set2,1,1,False,0.16992500144231237,6,0,start0,aligned
20,study7Line,5.0,35,10,1635,11,stackbar,set4,-1,1,False,0.16992500144231237,11,0,start0,aligned
20,study7Line,6.0,36,10,1636,12,stackbar,set4,-2,2,False,1.0874628412503393,12,0,start0,aligned
20,study7Line,5.0,37,25,1637,23,stackbar,set1,2,2,False,1.0874628412503393,2,3,non-aligned,non-aligned
20,study7Line,8.0,38,35,1638,35,stackbar,set1,0,0,True,-3.0,10,6,non-aligned,non-aligned
20,study7Line,7.0,39,50,1639,45,stackbar,set2,5,5,False,2.357552004618084,5,9,non-aligned,non-aligned
20,study7Line,6.0,40,40,1640,43,stackbar,set2,-3,3,False,1.6438561897747246,7,2,non-aligned,non-aligned
20,study7Line,5.0,41,40,1641,43,stackbar,set2,-3,3,False,1.6438561897747246,7,0,start0,aligned
20,study7Line,5.0,42,35,1642,41,stackbar,set4,-6,6,False,2.6147098441152083,9,0,start0,aligned
20,study7Line,4.0,43,25,1643,28,stackbar,set3,-3,3,False,1.6438561897747246,3,9,non-aligned,non-aligned
20,study7Line,6.0,44,20,1644,18,stackbar,set1,2,2,False,1.0874628412503393,7,0,start0,aligned
20,study7Line,7.0,45,15,1645,20,stackbar,set3,-5,5,False,2.357552004618084,5,2,non-aligned,non-aligned
20,study7Line,5.0,46,23,1646,24,stackbar,set2,-1,1,False,0.16992500144231237,1,0,start0,aligned
20,study7Line,4.0,47,23,1647,25,stackbar,set1,-2,2,False,1.0874628412503393,0,7,non-aligned,non-aligned
20,study7Line,8.0,48,40,1648,45,stackbar,set4,-5,5,False,2.357552004618084,5,0,start0,aligned
20,study7Line,7.0,49,16,1649,16,stackbar,set2,0,0,True,-3.0,9,0,start0,aligned
20,study7Line,4.0,50,14,1650,15,stackbar,set1,-1,1,False,0.16992500144231237,10,0,start0,aligned
20,study7Line,5.0,51,22,1651,21,stackbar,set1,1,1,False,0.16992500144231237,4,0,start0,aligned
20,study7Line,4.0,52,25,1652,25,stackbar,set2,0,0,True,-3.0,0,0,start0,aligned
20,study7Line,11.0,53,30,1653,37,stackbar,set4,-7,7,False,2.8328900141647417,12,1,non-aligned,non-aligned
20,study7Line,11.0,54,28,1654,31,stackbar,set1,-3,3,False,1.6438561897747246,6,4,non-aligned,non-aligned
20,study7Line,4.0,55,25,1655,26,stackbar,set4,-1,1,False,0.16992500144231237,1,1,non-aligned,non-aligned
20,study7Line,5.0,56,20,1656,20,stackbar,set3,0,0,True,-3.0,5,0,start0,aligned
20,study7Line,6.0,57,30,1657,33,stackbar,set4,-3,3,False,1.6438561897747246,8,4,non-aligned,non-aligned
20,study7Line,5.0,58,15,1658,15,stackbar,set1,0,0,True,-3.0,10,5,non-aligned,non-aligned
20,study7Line,10.0,59,18,1659,17,stackbar,set1,1,1,False,0.16992500144231237,8,0,start0,aligned
20,study7Line,47.0,60,28,1660,28,stackbar,set4,0,0,True,-3.0,3,0,start0,aligned
20,study7Line,6.0,61,35,1661,40,stackbar,set3,-5,5,False,2.357552004618084,10,2,non-aligned,non-aligned
20,study7Line,12.0,62,20,1662,19,stackbar,set1,1,1,False,0.16992500144231237,6,0,start0,aligned
20,study7Line,18.0,63,30,1663,30,stackbar,set4,0,0,True,-3.0,5,0,start0,aligned
20,study7Line,25.0,64,40,1664,44,stackbar,set1,-4,4,False,2.0443941193584534,6,2,non-aligned,non-aligned
20,study7Line,5.0,65,30,1665,32,stackbar,set2,-2,2,False,1.0874628412503393,7,0,start0,aligned
20,study7Line,4.0,66,48,1666,48,stackbar,set4,0,0,True,-3.0,2,0,start0,aligned
20,study7Line,7.0,67,45,1667,47,stackbar,set3,-2,2,False,1.0874628412503393,3,10,non-aligned,non-aligned
20,study7Line,7.0,68,12,1668,11,stackbar,set2,1,1,False,0.16992500144231237,11,2,non-aligned,non-aligned
20,study7Line,5.0,69,35,1669,39,stackbar,set3,-4,4,False,2.0443941193584534,11,3,non-aligned,non-aligned
20,study7Line,9.0,70,35,1670,40,stackbar,set4,-5,5,False,2.357552004618084,10,0,start0,aligned
20,study7Line,8.0,71,22,1671,21,stackbar,set3,1,1,False,0.16992500144231237,4,2,non-aligned,non-aligned
20,study7Line,7.0,72,28,1672,32,stackbar,set4,-4,4,False,2.0443941193584534,7,7,non-aligned,non-aligned
20,study7Line,7.0,73,50,1673,49,stackbar,set2,1,1,False,0.16992500144231237,1,8,non-aligned,non-aligned
20,study7Line,5.0,74,12,1674,12,stackbar,set4,0,0,True,-3.0,12,6,non-aligned,non-aligned
20,study7Line,8.0,75,40,1675,38,stackbar,set3,2,2,False,1.0874628412503393,12,3,non-aligned,non-aligned
20,study7Line,10.0,76,45,1676,42,stackbar,set3,3,3,False,1.6438561897747246,8,7,non-aligned,non-aligned
20,study7Line,7.0,77,22,1677,17,stackbar,set4,5,5,False,2.357552004618084,8,1,non-aligned,non-aligned
20,study7Line,9.0,78,30,1678,34,stackbar,set4,-4,4,False,2.0443941193584534,9,2,non-aligned,non-aligned
20,study7Line,6.0,79,20,1679,22,stackbar,set4,-2,2,False,1.0874628412503393,3,0,start0,aligned
15,study7Line,16.0,0,15,1200,15,stackbar,set3,0,0,True,-3.0,10,3,non-aligned,non-aligned
15,study7Line,12.0,1,45,1201,43,stackbar,set1,2,2,False,1.0874628412503393,7,0,start0,aligned
15,study7Line,9.0,2,20,1202,19,stackbar,set2,1,1,False,0.16992500144231237,6,0,start0,aligned
15,study7Line,18.0,3,35,1203,35,stackbar,set2,0,0,True,-3.0,10,0,start0,aligned
15,study7Line,18.0,4,40,1204,39,stackbar,set2,1,1,False,0.16992500144231237,11,1,non-aligned,non-aligned
15,study7Line,17.0,5,37,1205,37,stackbar,set1,0,0,True,-3.0,12,0,start0,aligned
15,study7Line,10.0,6,22,1206,23,stackbar,set2,-1,1,False,0.16992500144231237,2,0,start0,aligned
15,study7Line,6.0,7,24,1207,24,stackbar,set3,0,0,True,-3.0,1,0,start0,aligned
15,study7Line,10.0,8,25,1208,24,stackbar,set3,1,1,False,0.16992500144231237,1,8,non-aligned,non-aligned
15,study7Line,12.0,9,30,1209,29,stackbar,set2,1,1,False,0.16992500144231237,4,0,start0,aligned
15,study7Line,9.0,10,10,1210,11,stackbar,set2,-1,1,False,0.16992500144231237,11,0,start0,aligned
15,study7Line,8.0,11,35,1211,31,stackbar,set1,4,4,False,2.0443941193584534,6,4,non-aligned,non-aligned
15,study7Line,14.0,12,35,1212,36,stackbar,set4,-1,1,False,0.16992500144231237,11,0,start0,aligned
15,study7Line,5.0,13,45,1213,46,stackbar,set4,-1,1,False,0.16992500144231237,4,0,start0,aligned
15,study7Line,17.0,14,45,1214,44,stackbar,set2,1,1,False,0.16992500144231237,6,9,non-aligned,non-aligned
15,study7Line,10.0,15,20,1215,18,stackbar,set1,2,2,False,1.0874628412503393,7,1,non-aligned,non-aligned
15,study7Line,9.0,16,12,1216,15,stackbar,set1,-3,3,False,1.6438561897747246,10,0,start0,aligned
15,study7Line,8.0,17,47,1217,47,stackbar,set2,0,0,True,-3.0,3,0,start0,aligned
15,study7Line,10.0,18,22,1218,22,stackbar,set4,0,0,True,-3.0,3,0,start75,aligned
15,study7Line,9.0,19,35,1219,34,stackbar,set2,1,1,False,0.16992500144231237,9,2,non-aligned,non-aligned
15,study7Line,5.0,20,50,1220,50,stackbar,set4,0,0,True,-3.0,0,0,start0,aligned
15,study7Line,6.0,21,30,1221,30,stackbar,set2,0,0,True,-3.0,5,0,start0,aligned
15,study7Line,6.0,22,26,1222,26,stackbar,set4,0,0,True,-3.0,1,0,start0,aligned
15,study7Line,6.0,23,30,1223,29,stackbar,set4,1,1,False,0.16992500144231237,4,3,non-aligned,non-aligned
15,study7Line,16.0,24,50,1224,49,stackbar,set1,1,1,False,0.16992500144231237,1,8,non-aligned,non-aligned
15,study7Line,13.0,25,17,1225,14,stackbar,set2,3,3,False,1.6438561897747246,11,4,non-aligned,non-aligned
15,study7Line,13.0,26,40,1226,43,stackbar,set3,-3,3,False,1.6438561897747246,7,3,non-aligned,non-aligned
15,study7Line,6.0,27,40,1227,40,stackbar,set2,0,0,True,-3.0,10,1,non-aligned,non-aligned
15,study7Line,5.0,28,27,1228,27,stackbar,set3,0,0,True,-3.0,2,0,start0,aligned
15,study7Line,11.0,29,40,1229,38,stackbar,set3,2,2,False,1.0874628412503393,12,0,start0,aligned
15,study7Line,8.0,30,14,1230,16,stackbar,set2,-2,2,False,1.0874628412503393,9,0,start0,aligned
15,study7Line,5.0,31,21,1231,22,stackbar,set2,-1,1,False,0.16992500144231237,3,0,start0,aligned
15,study7Line,12.0,32,42,1232,37,stackbar,set4,5,5,False,2.357552004618084,12,1,non-aligned,non-aligned
15,study7Line,24.0,33,33,1233,30,stackbar,set1,3,3,False,1.6438561897747246,5,8,non-aligned,non-aligned
15,study7Line,9.0,34,37,1234,39,stackbar,set2,-2,2,False,1.0874628412503393,11,0,start0,aligned
15,study7Line,14.0,35,23,1235,21,stackbar,set2,2,2,False,1.0874628412503393,4,6,non-aligned,non-aligned
15,study7Line,9.0,36,47,1236,47,stackbar,set2,0,0,True,-3.0,3,2,non-aligned,non-aligned
15,study7Line,7.0,37,49,1237,49,stackbar,set4,0,0,True,-3.0,1,0,start0,aligned
15,study7Line,15.0,38,40,1238,42,stackbar,set3,-2,2,False,1.0874628412503393,8,7,non-aligned,non-aligned
15,study7Line,10.0,39,37,1239,35,stackbar,set3,2,2,False,1.0874628412503393,10,2,non-aligned,non-aligned
15,study7Line,9.0,40,32,1240,33,stackbar,set4,-1,1,False,0.16992500144231237,8,0,start0,aligned
15,study7Line,14.0,41,37,1241,38,stackbar,set4,-1,1,False,0.16992500144231237,12,6,non-aligned,non-aligned
15,study7Line,7.0,42,18,1242,13,stackbar,set4,5,5,False,2.357552004618084,12,6,non-aligned,non-aligned
15,study7Line,7.0,43,35,1243,32,stackbar,set3,3,3,False,1.6438561897747246,7,2,non-aligned,non-aligned
15,study7Line,7.0,44,30,1244,31,stackbar,set1,-1,1,False,0.16992500144231237,6,0,start0,aligned
15,study7Line,16.0,45,47,1245,46,stackbar,set3,1,1,False,0.16992500144231237,4,10,non-aligned,non-aligned
15,study7Line,6.0,46,50,1246,48,stackbar,set4,2,2,False,1.0874628412503393,2,2,non-aligned,non-aligned
15,study7Line,7.0,47,35,1247,34,stackbar,set3,1,1,False,0.16992500144231237,9,0,start0,aligned
15,study7Line,8.0,48,13,1248,14,stackbar,set4,-1,1,False,0.16992500144231237,11,0,start0,aligned
15,study7Line,7.0,49,40,1249,40,stackbar,set1,0,0,True,-3.0,10,0,start0,aligned
15,study7Line,8.0,50,15,1250,17,stackbar,set1,-2,2,False,1.0874628412503393,8,0,start0,aligned
15,study7Line,11.0,51,11,1251,13,stackbar,set3,-2,2,False,1.0874628412503393,12,0,start0,aligned
15,study7Line,6.0,52,27,1252,28,stackbar,set1,-1,1,False,0.16992500144231237,3,0,start0,aligned
15,study7Line,7.0,53,20,1253,20,stackbar,set1,0,0,True,-3.0,5,0,start75,aligned
15,study7Line,9.0,54,20,1254,19,stackbar,set4,1,1,False,0.16992500144231237,6,0,end75,aligned
15,study7Line,4.0,55,25,1255,25,stackbar,set3,0,0,True,-3.0,0,0,start0,aligned
15,study7Line,7.0,56,20,1256,20,stackbar,set3,0,0,True,-3.0,5,0,start0,aligned
15,study7Line,6.0,57,20,1257,21,stackbar,set3,-1,1,False,0.16992500144231237,4,0,start0,aligned
15,study7Line,6.0,58,25,1258,25,stackbar,set3,0,0,True,-3.0,0,5,non-aligned,non-aligned
15,study7Line,10.0,59,10,1259,11,stackbar,set2,-1,1,False,0.16992500144231237,11,2,non-aligned,non-aligned
15,study7Line,6.0,60,25,1260,28,stackbar,set1,-3,3,False,1.6438561897747246,3,10,non-aligned,non-aligned
15,study7Line,6.0,61,48,1261,48,stackbar,set3,0,0,True,-3.0,2,0,start0,aligned
15,study7Line,5.0,62,50,1262,50,stackbar,set2,0,0,True,-3.0,0,4,non-aligned,non-aligned
15,study7Line,11.0,63,33,1263,33,stackbar,set4,0,0,True,-3.0,8,4,non-aligned,non-aligned
15,study7Line,8.0,64,42,1264,41,stackbar,set3,1,1,False,0.16992500144231237,9,1,non-aligned,non-aligned
15,study7Line,11.0,65,42,1265,44,stackbar,set1,-2,2,False,1.0874628412503393,6,0,start0,aligned
15,study7Line,13.0,66,16,1266,16,stackbar,set2,0,0,True,-3.0,9,2,non-aligned,non-aligned
15,study7Line,4.0,67,11,1267,12,stackbar,set1,-1,1,False,0.16992500144231237,12,0,start0,aligned
15,study7Line,7.0,68,23,1268,23,stackbar,set1,0,0,True,-3.0,2,3,non-aligned,non-aligned
15,study7Line,7.0,69,40,1269,42,stackbar,set3,-2,2,False,1.0874628412503393,8,0,start0,aligned
15,study7Line,7.0,70,35,1270,36,stackbar,set2,-1,1,False,0.16992500144231237,11,1,non-aligned,non-aligned
15,study7Line,10.0,71,12,1271,12,stackbar,set1,0,0,True,-3.0,12,1,non-aligned,non-aligned
15,study7Line,11.0,72,40,1272,45,stackbar,set2,-5,5,False,2.357552004618084,5,9,non-aligned,non-aligned
15,study7Line,5.0,73,25,1273,26,stackbar,set2,-1,1,False,0.16992500144231237,1,10,non-aligned,non-aligned
15,study7Line,11.0,74,44,1274,45,stackbar,set2,-1,1,False,0.16992500144231237,5,0,start0,aligned
15,study7Line,7.0,75,19,1275,18,stackbar,set1,1,1,False,0.16992500144231237,7,0,start0,aligned
15,study7Line,6.0,76,25,1276,27,stackbar,set2,-2,2,False,1.0874628412503393,2,11,non-aligned,non-aligned
15,study7Line,6.0,77,30,1277,32,stackbar,set1,-2,2,False,1.0874628412503393,7,0,start0,aligned
15,study7Line,5.0,78,20,1278,17,stackbar,set2,3,3,False,1.6438561897747246,8,5,non-aligned,non-aligned
15,study7Line,6.0,79,40,1279,41,stackbar,set1,-1,1,False,0.16992500144231237,9,0,start0,aligned
12,study7Line,10.0,0,12,960,12,stackbar,set1,0,0,True,-3.0,12,0,start0,aligned
12,study7Line,15.0,1,25,961,39,stackbar,set3,-14,14,False,3.820178962415188,11,3,non-aligned,non-aligned
12,study7Line,15.0,2,40,962,37,stackbar,set3,3,3,False,1.6438561897747246,12,0,start25,aligned
12,study7Line,11.0,3,30,963,32,stackbar,set4,-2,2,False,1.0874628412503393,7,7,non-aligned,non-aligned
12,study7Line,6.0,4,50,964,49,stackbar,set3,1,1,False,0.16992500144231237,1,1,non-aligned,non-aligned
12,study7Line,7.0,5,40,965,42,stackbar,set1,-2,2,False,1.0874628412503393,8,3,non-aligned,non-aligned
12,study7Line,7.0,6,35,966,34,stackbar,set1,1,1,False,0.16992500144231237,9,0,start0,aligned
12,study7Line,7.0,7,45,967,43,stackbar,set2,2,2,False,1.0874628412503393,7,2,non-aligned,non-aligned
12,study7Line,7.0,8,15,968,15,stackbar,set1,0,0,True,-3.0,10,5,non-aligned,non-aligned
12,study7Line,10.0,9,40,969,42,stackbar,set3,-2,2,False,1.0874628412503393,8,0,start0,aligned
12,study7Line,6.0,10,25,970,23,stackbar,set3,2,2,False,1.0874628412503393,2,10,non-aligned,non-aligned
12,study7Line,4.0,11,20,971,22,stackbar,set3,-2,2,False,1.0874628412503393,3,0,start0,aligned
12,study7Line,6.0,12,40,972,40,stackbar,set1,0,0,True,-3.0,10,0,start0,aligned
12,study7Line,6.0,13,20,973,19,stackbar,set3,1,1,False,0.16992500144231237,6,0,start0,aligned
12,study7Line,7.0,14,50,974,47,stackbar,set4,3,3,False,1.6438561897747246,3,10,non-aligned,non-aligned
12,study7Line,7.0,15,27,975,28,stackbar,set4,-1,1,False,0.16992500144231237,3,0,start0,aligned
12,study7Line,6.0,16,30,976,32,stackbar,set3,-2,2,False,1.0874628412503393,7,0,start0,aligned
12,study7Line,11.0,17,27,977,27,stackbar,set1,0,0,True,-3.0,2,2,non-aligned,non-aligned
12,study7Line,6.0,18,35,978,37,stackbar,set2,-2,2,False,1.0874628412503393,12,0,start0,aligned
12,study7Line,6.0,19,45,979,46,stackbar,set4,-1,1,False,0.16992500144231237,4,0,start0,aligned
12,study7Line,5.0,20,25,980,25,stackbar,set4,0,0,True,-3.0,0,0,start0,aligned
12,study7Line,5.0,21,22,981,21,stackbar,set1,1,1,False,0.16992500144231237,4,1,non-aligned,non-aligned
12,study7Line,7.0,22,30,982,31,stackbar,set4,-1,1,False,0.16992500144231237,6,0,start0,aligned
12,study7Line,7.0,23,30,983,31,stackbar,set1,-1,1,False,0.16992500144231237,6,4,non-aligned,non-aligned
12,study7Line,9.0,24,48,984,48,stackbar,set4,0,0,True,-3.0,2,2,non-aligned,non-aligned
12,study7Line,7.0,25,48,985,47,stackbar,set3,1,1,False,0.16992500144231237,3,0,start0,aligned
12,study7Line,6.0,26,49,986,48,stackbar,set2,1,1,False,0.16992500144231237,2,0,start0,aligned
12,study7Line,4.0,27,50,987,50,stackbar,set2,0,0,True,-3.0,0,0,start0,aligned
12,study7Line,11.0,28,12,988,13,stackbar,set3,-1,1,False,0.16992500144231237,12,0,start0,aligned
12,study7Line,5.0,29,20,989,22,stackbar,set4,-2,2,False,1.0874628412503393,3,0,start75,aligned
12,study7Line,7.0,30,20,990,17,stackbar,set4,3,3,False,1.6438561897747246,8,1,non-aligned,non-aligned
12,study7Line,7.0,31,28,991,30,stackbar,set1,-2,2,False,1.0874628412503393,5,0,start0,aligned
12,study7Line,8.0,32,37,992,39,stackbar,set4,-2,2,False,1.0874628412503393,11,0,start0,aligned
12,study7Line,7.0,33,50,993,41,stackbar,set1,9,9,False,3.189824558880017,9,6,non-aligned,non-aligned
12,study7Line,8.0,34,17,994,19,stackbar,set1,-2,2,False,1.0874628412503393,6,8,non-aligned,non-aligned
12,study7Line,6.0,35,30,995,33,stackbar,set2,-3,3,False,1.6438561897747246,8,8,non-aligned,non-aligned
12,study7Line,13.0,36,35,996,40,stackbar,set3,-5,5,False,2.357552004618084,10,2,non-aligned,non-aligned
12,study7Line,34.0,37,24,997,24,stackbar,set2,0,0,True,-3.0,1,0,start0,aligned
12,study7Line,8.0,38,24,998,28,stackbar,set4,-4,4,False,2.0443941193584534,3,5,non-aligned,non-aligned
12,study7Line,5.0,39,13,999,16,stackbar,set4,-3,3,False,1.6438561897747246,9,0,start0,aligned
12,study7Line,7.0,40,40,1000,44,stackbar,set4,-4,4,False,2.0443941193584534,6,2,non-aligned,non-aligned
12,study7Line,13.0,41,50,1001,45,stackbar,set2,5,5,False,2.357552004618084,5,9,non-aligned,non-aligned
12,study7Line,5.0,42,30,1002,29,stackbar,set3,1,1,False,0.16992500144231237,4,9,non-aligned,non-aligned
12,study7Line,4.0,43,15,1003,16,stackbar,set3,-1,1,False,0.16992500144231237,9,3,non-aligned,non-aligned
12,study7Line,9.0,44,32,1004,35,stackbar,set3,-3,3,False,1.6438561897747246,10,0,start0,aligned
12,study7Line,8.0,45,23,1005,23,stackbar,set1,0,0,True,-3.0,2,0,start0,aligned
12,study7Line,5.0,46,26,1006,27,stackbar,set3,-1,1,False,0.16992500144231237,2,0,start0,aligned
12,study7Line,4.0,47,27,1007,29,stackbar,set1,-2,2,False,1.0874628412503393,4,0,start0,aligned
12,study7Line,6.0,48,32,1008,38,stackbar,set3,-6,6,False,2.6147098441152083,12,3,non-aligned,non-aligned
12,study7Line,4.0,49,49,1009,49,stackbar,set1,0,0,True,-3.0,1,0,start0,aligned
12,study7Line,5.0,50,45,1010,45,stackbar,set2,0,0,True,-3.0,5,0,start0,aligned
12,study7Line,6.0,51,20,1011,21,stackbar,set3,-1,1,False,0.16992500144231237,4,0,start0,aligned
12,study7Line,7.0,52,50,1012,46,stackbar,set3,4,4,False,2.0443941193584534,4,10,non-aligned,non-aligned
12,study7Line,6.0,53,15,1013,12,stackbar,set3,3,3,False,1.6438561897747246,12,1,non-aligned,non-aligned
12,study7Line,5.0,54,40,1014,43,stackbar,set1,-3,3,False,1.6438561897747246,7,0,start0,aligned
12,study7Line,9.0,55,20,1015,20,stackbar,set1,0,0,True,-3.0,5,0,start75,aligned
12,study7Line,4.0,56,13,1016,15,stackbar,set2,-2,2,False,1.0874628412503393,10,0,start0,aligned
12,study7Line,3.0,57,12,1017,11,stackbar,set3,1,1,False,0.16992500144231237,11,0,start0,aligned
12,study7Line,4.0,58,26,1018,26,stackbar,set1,0,0,True,-3.0,1,0,start0,aligned
12,study7Line,4.0,59,55,1019,50,stackbar,set1,5,5,False,2.357552004618084,0,6,non-aligned,non-aligned
12,study7Line,12.0,60,40,1020,36,stackbar,set4,4,4,False,2.0443941193584534,11,0,start0,aligned
12,study7Line,7.0,61,45,1021,41,stackbar,set3,4,4,False,2.0443941193584534,9,0,start0,aligned
12,study7Line,6.0,62,18,1022,20,stackbar,set2,-2,2,False,1.0874628412503393,5,0,start0,aligned
12,study7Line,4.0,63,32,1023,33,stackbar,set3,-1,1,False,0.16992500144231237,8,0,start0,aligned
12,study7Line,7.0,64,32,1024,36,stackbar,set1,-4,4,False,2.0443941193584534,11,3,non-aligned,non-aligned
12,study7Line,4.0,65,25,1025,24,stackbar,set4,1,1,False,0.16992500144231237,1,9,non-aligned,non-aligned
12,study7Line,4.0,66,17,1026,17,stackbar,set4,0,0,True,-3.0,8,0,start0,aligned
12,study7Line,3.0,67,12,1027,14,stackbar,set1,-2,2,False,1.0874628412503393,11,0,start0,aligned
12,study7Line,4.0,68,12,1028,13,stackbar,set1,-1,1,False,0.16992500144231237,12,6,non-aligned,non-aligned
12,study7Line,6.0,69,26,1029,26,stackbar,set3,0,0,True,-3.0,1,3,non-aligned,non-aligned
12,study7Line,10.0,70,35,1030,38,stackbar,set3,-3,3,False,1.6438561897747246,12,0,start0,aligned
12,study7Line,8.0,71,15,1031,14,stackbar,set2,1,1,False,0.16992500144231237,11,4,non-aligned,non-aligned
12,study7Line,5.0,72,25,1032,25,stackbar,set2,0,0,True,-3.0,0,8,non-aligned,non-aligned
12,study7Line,4.0,73,18,1033,18,stackbar,set3,0,0,True,-3.0,7,0,start0,aligned
12,study7Line,4.0,74,10,1034,11,stackbar,set3,-1,1,False,0.16992500144231237,11,5,non-aligned,non-aligned
12,study7Line,10.0,75,28,1035,34,stackbar,set3,-6,6,False,2.6147098441152083,9,3,non-aligned,non-aligned
12,study7Line,5.0,76,45,1036,44,stackbar,set1,1,1,False,0.16992500144231237,6,0,start0,aligned
12,study7Line,5.0,77,26,1037,30,stackbar,set1,-4,4,False,2.0443941193584534,5,8,non-aligned,non-aligned
12,study7Line,4.0,78,20,1038,18,stackbar,set2,2,2,False,1.0874628412503393,7,1,non-aligned,non-aligned
12,study7Line,7.0,79,32,1039,35,stackbar,set1,-3,3,False,1.6438561897747246,10,6,non-aligned,non-aligned
25,study7Line,17.0,0,33,2000,36,stackbar,set2,-3,3,False,1.6438561897747246,11,0,start0,aligned
25,study7Line,15.0,1,50,2001,49,stackbar,set1,1,1,False,0.16992500144231237,1,8,non-aligned,non-aligned
25,study7Line,14.0,2,31,2002,30,stackbar,set3,1,1,False,0.16992500144231237,5,7,non-aligned,non-aligned
25,study7Line,13.0,3,42,2003,44,stackbar,set4,-2,2,False,1.0874628412503393,6,0,start0,aligned
25,study7Line,14.0,4,50,2004,47,stackbar,set3,3,3,False,1.6438561897747246,3,10,non-aligned,non-aligned
25,study7Line,17.0,5,15,2005,15,stackbar,set4,0,0,True,-3.0,10,4,non-aligned,non-aligned
25,study7Line,17.0,6,8,2006,11,stackbar,set3,-3,3,False,1.6438561897747246,11,5,non-aligned,non-aligned
25,study7Line,15.0,7,42,2007,43,stackbar,set2,-1,1,False,0.16992500144231237,7,2,non-aligned,non-aligned
25,study7Line,12.0,8,25,2008,21,stackbar,set2,4,4,False,2.0443941193584534,4,6,non-aligned,non-aligned
25,study7Line,12.0,9,10,2009,11,stackbar,set1,-1,1,False,0.16992500144231237,11,0,start0,aligned
25,study7Line,11.0,10,12,2010,13,stackbar,set1,-1,1,False,0.16992500144231237,12,6,non-aligned,non-aligned
25,study7Line,11.0,11,20,2011,19,stackbar,set4,1,1,False,0.16992500144231237,6,0,start0,aligned
25,study7Line,13.0,12,44,2012,46,stackbar,set4,-2,2,False,1.0874628412503393,4,2,non-aligned,non-aligned
25,study7Line,9.0,13,25,2013,25,stackbar,set1,0,0,True,-3.0,0,0,start0,aligned
25,study7Line,11.0,14,23,2014,22,stackbar,set1,1,1,False,0.16992500144231237,3,0,start0,aligned
25,study7Line,11.0,15,22,2015,24,stackbar,set1,-2,2,False,1.0874628412503393,1,5,non-aligned,non-aligned
25,study7Line,11.0,16,45,2016,42,stackbar,set3,3,3,False,1.6438561897747246,8,7,non-aligned,non-aligned
25,study7Line,12.0,17,30,2017,31,stackbar,set3,-1,1,False,0.16992500144231237,6,2,non-aligned,non-aligned
25,study7Line,8.0,18,12,2018,14,stackbar,set4,-2,2,False,1.0874628412503393,11,0,start0,aligned
25,study7Line,9.0,19,45,2019,44,stackbar,set1,1,1,False,0.16992500144231237,6,2,non-aligned,non-aligned
25,study7Line,12.0,20,35,2020,32,stackbar,set4,3,3,False,1.6438561897747246,7,7,non-aligned,non-aligned
25,study7Line,12.0,21,36,2021,37,stackbar,set1,-1,1,False,0.16992500144231237,12,0,start0,aligned
25,study7Line,13.0,22,32,2022,32,stackbar,set4,0,0,True,-3.0,7,0,start0,aligned
25,study7Line,12.0,23,40,2023,39,stackbar,set4,1,1,False,0.16992500144231237,11,1,non-aligned,non-aligned
25,study7Line,15.0,24,33,2024,38,stackbar,set2,-5,5,False,2.357552004618084,12,0,start0,aligned
25,study7Line,10.0,25,32,2025,34,stackbar,set3,-2,2,False,1.0874628412503393,9,0,start0,aligned
25,study7Line,9.0,26,50,2026,50,stackbar,set2,0,0,True,-3.0,0,0,start0,aligned
25,study7Line,11.0,27,20,2027,20,stackbar,set3,0,0,True,-3.0,5,2,non-aligned,non-aligned
25,study7Line,12.0,28,22,2028,22,stackbar,set3,0,0,True,-3.0,3,2,non-aligned,non-aligned
25,study7Line,11.0,29,25,2029,27,stackbar,set2,-2,2,False,1.0874628412503393,2,11,non-aligned,non-aligned
25,study7Line,12.0,30,45,2030,45,stackbar,set3,0,0,True,-3.0,5,0,start0,aligned
25,study7Line,12.0,31,44,2031,46,stackbar,set3,-2,2,False,1.0874628412503393,4,0,start0,aligned
25,study7Line,15.0,32,20,2032,20,stackbar,set3,0,0,True,-3.0,5,0,start0,aligned
25,study7Line,15.0,33,38,2033,35,stackbar,set4,3,3,False,1.6438561897747246,10,0,end100,aligned
25,study7Line,15.0,34,45,2034,47,stackbar,set3,-2,2,False,1.0874628412503393,3,0,start0,aligned
25,study7Line,10.0,35,13,2035,14,stackbar,set1,-1,1,False,0.16992500144231237,11,5,non-aligned,non-aligned
25,study7Line,13.0,36,28,2036,28,stackbar,set2,0,0,True,-3.0,3,0,start0,aligned
25,study7Line,14.0,37,40,2037,37,stackbar,set3,3,3,False,1.6438561897747246,12,0,start25,aligned
25,study7Line,15.0,38,14,2038,16,stackbar,set4,-2,2,False,1.0874628412503393,9,0,start0,aligned
25,study7Line,18.0,39,39,2039,41,stackbar,set4,-2,2,False,1.0874628412503393,9,0,start0,aligned
25,study7Line,11.0,40,41,2040,40,stackbar,set1,1,1,False,0.16992500144231237,10,0,start0,aligned
25,study7Line,11.0,41,42,2041,43,stackbar,set3,-1,1,False,0.16992500144231237,7,0,start0,aligned
25,study7Line,23.0,42,20,2042,16,stackbar,set3,4,4,False,2.0443941193584534,9,3,non-aligned,non-aligned
25,study7Line,14.0,43,34,2043,33,stackbar,set1,1,1,False,0.16992500144231237,8,6,non-aligned,non-aligned
25,study7Line,9.0,44,28,2044,29,stackbar,set2,-1,1,False,0.16992500144231237,4,0,start0,aligned
25,study7Line,18.0,45,10,2045,12,stackbar,set3,-2,2,False,1.0874628412503393,12,1,non-aligned,non-aligned
25,study7Line,15.0,46,40,2046,42,stackbar,set1,-2,2,False,1.0874628412503393,8,0,start0,aligned
25,study7Line,11.0,47,30,2047,28,stackbar,set1,2,2,False,1.0874628412503393,3,10,non-aligned,non-aligned
25,study7Line,9.0,48,13,2048,15,stackbar,set4,-2,2,False,1.0874628412503393,10,0,start0,aligned
25,study7Line,11.0,49,28,2049,30,stackbar,set1,-2,2,False,1.0874628412503393,5,0,start0,aligned
25,study7Line,12.0,50,28,2050,31,stackbar,set1,-3,3,False,1.6438561897747246,6,0,start0,aligned
25,study7Line,15.0,51,20,2051,19,stackbar,set2,1,1,False,0.16992500144231237,6,2,non-aligned,non-aligned
25,study7Line,11.0,52,49,2052,49,stackbar,set4,0,0,True,-3.0,1,0,start0,aligned
25,study7Line,15.0,53,46,2053,45,stackbar,set1,1,1,False,0.16992500144231237,5,2,non-aligned,non-aligned
25,study7Line,9.0,54,23,2054,23,stackbar,set1,0,0,True,-3.0,2,0,start0,aligned
25,study7Line,16.0,55,40,2055,40,stackbar,set2,0,0,True,-3.0,10,1,non-aligned,non-aligned
25,study7Line,7.0,56,22,2056,21,stackbar,set4,1,1,False,0.16992500144231237,4,0,start0,aligned
25,study7Line,9.0,57,24,2057,24,stackbar,set1,0,0,True,-3.0,1,0,start0,aligned
25,study7Line,16.0,58,18,2058,17,stackbar,set4,1,1,False,0.16992500144231237,8,1,non-aligned,non-aligned
25,study7Line,10.0,59,35,2059,36,stackbar,set4,-1,1,False,0.16992500144231237,11,3,non-aligned,non-aligned
25,study7Line,10.0,60,48,2060,48,stackbar,set3,0,0,True,-3.0,2,0,start0,aligned
25,study7Line,7.0,61,26,2061,26,stackbar,set4,0,0,True,-3.0,1,0,start0,aligned
25,study7Line,10.0,62,27,2062,26,stackbar,set2,1,1,False,0.16992500144231237,1,10,non-aligned,non-aligned
25,study7Line,10.0,63,33,2063,35,stackbar,set3,-2,2,False,1.0874628412503393,10,0,start0,aligned
25,study7Line,9.0,64,50,2064,50,stackbar,set3,0,0,True,-3.0,0,5,non-aligned,non-aligned
25,study7Line,15.0,65,17,2065,18,stackbar,set3,-1,1,False,0.16992500144231237,7,2,non-aligned,non-aligned
25,study7Line,9.0,66,10,2066,12,stackbar,set1,-2,2,False,1.0874628412503393,12,0,start0,aligned
25,study7Line,7.0,67,26,2067,27,stackbar,set4,-1,1,False,0.16992500144231237,2,0,start0,aligned
25,study7Line,11.0,68,15,2068,17,stackbar,set2,-2,2,False,1.0874628412503393,8,0,start0,aligned
25,study7Line,12.0,69,33,2069,34,stackbar,set4,-1,1,False,0.16992500144231237,9,2,non-aligned,non-aligned
25,study7Line,15.0,70,34,2070,38,stackbar,set1,-4,4,False,2.0443941193584534,12,1,non-aligned,non-aligned
25,study7Line,16.0,71,30,2071,33,stackbar,set2,-3,3,False,1.6438561897747246,8,0,start0,aligned
25,study7Line,10.0,72,12,2072,13,stackbar,set1,-1,1,False,0.16992500144231237,12,0,start0,aligned
25,study7Line,11.0,73,48,2073,48,stackbar,set3,0,0,True,-3.0,2,2,non-aligned,non-aligned
25,study7Line,12.0,74,37,2074,39,stackbar,set4,-2,2,False,1.0874628412503393,11,0,start0,aligned
25,study7Line,10.0,75,25,2075,23,stackbar,set4,2,2,False,1.0874628412503393,2,10,non-aligned,non-aligned
25,study7Line,10.0,76,35,2076,41,stackbar,set3,-6,6,False,2.6147098441152083,9,1,non-aligned,non-aligned
25,study7Line,12.0,77,27,2077,29,stackbar,set4,-2,2,False,1.0874628412503393,4,3,non-aligned,non-aligned
25,study7Line,8.0,78,25,2078,25,stackbar,set4,0,0,True,-3.0,0,0,start25,aligned
25,study7Line,10.0,79,20,2079,18,stackbar,set4,2,2,False,1.0874628412503393,7,0,start0,aligned
17,study7Line,11.0,0,45,1360,42,stackbar,set2,3,3,False,1.6438561897747246,8,0,start0,aligned
17,study7Line,9.0,1,10,1361,13,stackbar,set3,-3,3,False,1.6438561897747246,12,0,start0,aligned
17,study7Line,10.0,2,20,1362,19,stackbar,set2,1,1,False,0.16992500144231237,6,2,non-aligned,non-aligned
17,study7Line,9.0,3,20,1363,18,stackbar,set4,2,2,False,1.0874628412503393,7,0,start0,aligned
17,study7Line,7.0,4,30,1364,32,stackbar,set3,-2,2,False,1.0874628412503393,7,2,non-aligned,non-aligned
17,study7Line,11.0,5,15,1365,14,stackbar,set1,1,1,False,0.16992500144231237,11,5,non-aligned,non-aligned
17,study7Line,8.0,6,20,1366,15,stackbar,set4,5,5,False,2.357552004618084,10,4,non-aligned,non-aligned
17,study7Line,3.0,7,45,1367,45,stackbar,set4,0,0,True,-3.0,5,0,start0,aligned
17,study7Line,8.0,8,40,1368,41,stackbar,set2,-1,1,False,0.16992500144231237,9,0,start0,aligned
17,study7Line,8.0,9,30,1369,34,stackbar,set1,-4,4,False,2.0443941193584534,9,6,non-aligned,non-aligned
17,study7Line,6.0,10,35,1370,36,stackbar,set1,-1,1,False,0.16992500144231237,11,0,start0,aligned
17,study7Line,4.0,11,30,1371,31,stackbar,set2,-1,1,False,0.16992500144231237,6,0,start0,aligned
17,study7Line,7.0,12,15,1372,17,stackbar,set2,-2,2,False,1.0874628412503393,8,0,start0,aligned
17,study7Line,11.0,13,25,1373,25,stackbar,set2,0,0,True,-3.0,0,8,non-aligned,non-aligned
17,study7Line,7.0,14,48,1374,47,stackbar,set2,1,1,False,0.16992500144231237,3,0,start0,aligned
17,study7Line,8.0,15,55,1375,31,stackbar,set2,24,24,False,4.592457037268081,6,1,non-aligned,non-aligned
17,study7Line,5.0,16,35,1376,32,stackbar,set4,3,3,False,1.6438561897747246,7,0,start0,aligned
17,study7Line,4.0,17,15,1377,16,stackbar,set3,-1,1,False,0.16992500144231237,9,0,start0,aligned
17,study7Line,19.0,18,30,1378,27,stackbar,set3,3,3,False,1.6438561897747246,2,6,non-aligned,non-aligned
17,study7Line,14.0,19,15,1379,14,stackbar,set3,1,1,False,0.16992500144231237,11,0,start0,aligned
17,study7Line,5.0,20,50,1380,41,stackbar,set2,9,9,False,3.189824558880017,9,4,non-aligned,non-aligned
17,study7Line,10.0,21,45,1381,47,stackbar,set1,-2,2,False,1.0874628412503393,3,2,non-aligned,non-aligned
17,study7Line,10.0,22,40,1382,42,stackbar,set1,-2,2,False,1.0874628412503393,8,3,non-aligned,non-aligned
17,study7Line,12.0,23,48,1383,46,stackbar,set2,2,2,False,1.0874628412503393,4,9,non-aligned,non-aligned
17,study7Line,8.0,24,40,1384,33,stackbar,set2,7,7,False,2.8328900141647417,8,8,non-aligned,non-aligned
17,study7Line,10.0,25,40,1385,39,stackbar,set2,1,1,False,0.16992500144231237,11,0,start0,aligned
17,study7Line,5.0,26,30,1386,30,stackbar,set3,0,0,True,-3.0,5,7,non-aligned,non-aligned
17,study7Line,3.0,27,15,1387,16,stackbar,set3,-1,1,False,0.16992500144231237,9,3,non-aligned,non-aligned
17,study7Line,9.0,28,50,1388,50,stackbar,set3,0,0,True,-3.0,0,5,non-aligned,non-aligned
17,study7Line,5.0,29,20,1389,18,stackbar,set3,2,2,False,1.0874628412503393,7,2,non-aligned,non-aligned
17,study7Line,6.0,30,40,1390,39,stackbar,set4,1,1,False,0.16992500144231237,11,1,non-aligned,non-aligned
17,study7Line,3.0,31,10,1391,13,stackbar,set1,-3,3,False,1.6438561897747246,12,6,non-aligned,non-aligned
17,study7Line,4.0,32,10,1392,12,stackbar,set2,-2,2,False,1.0874628412503393,12,0,start0,aligned
17,study7Line,15.0,33,50,1393,49,stackbar,set1,1,1,False,0.16992500144231237,1,8,non-aligned,non-aligned
17,study7Line,7.0,34,55,1394,45,stackbar,set1,10,10,False,3.3398500028846247,5,2,non-aligned,non-aligned
17,study7Line,7.0,35,25,1395,28,stackbar,set1,-3,3,False,1.6438561897747246,3,10,non-aligned,non-aligned
17,study7Line,4.0,36,30,1396,29,stackbar,set1,1,1,False,0.16992500144231237,4,0,start0,aligned
17,study7Line,3.0,37,25,1397,25,stackbar,set3,0,0,True,-3.0,0,0,start0,aligned
17,study7Line,3.0,38,45,1398,46,stackbar,set1,-1,1,False,0.16992500144231237,4,0,start0,aligned
17,study7Line,3.0,39,20,1399,21,stackbar,set4,-1,1,False,0.16992500144231237,4,0,start0,aligned
17,study7Line,3.0,40,10,1400,12,stackbar,set3,-2,2,False,1.0874628412503393,12,1,non-aligned,non-aligned
17,study7Line,3.0,41,25,1401,24,stackbar,set2,1,1,False,0.16992500144231237,1,2,non-aligned,non-aligned
17,study7Line,3.0,42,15,1402,15,stackbar,set4,0,0,True,-3.0,10,0,start0,aligned
17,study7Line,4.0,43,40,1403,35,stackbar,set3,5,5,False,2.357552004618084,10,0,start0,aligned
17,study7Line,4.0,44,50,1404,48,stackbar,set4,2,2,False,1.0874628412503393,2,2,non-aligned,non-aligned
17,study7Line,7.0,45,35,1405,33,stackbar,set2,2,2,False,1.0874628412503393,8,0,start0,aligned
17,study7Line,7.0,46,49,1406,49,stackbar,set3,0,0,True,-3.0,1,0,start0,aligned
17,study7Line,8.0,47,45,1407,44,stackbar,set2,1,1,False,0.16992500144231237,6,9,non-aligned,non-aligned
17,study7Line,7.0,48,20,1408,21,stackbar,set2,-1,1,False,0.16992500144231237,4,6,non-aligned,non-aligned
17,study7Line,11.0,49,20,1409,17,stackbar,set3,3,3,False,1.6438561897747246,8,3,non-aligned,non-aligned
17,study7Line,8.0,50,30,1410,29,stackbar,set1,1,1,False,0.16992500144231237,4,2,non-aligned,non-aligned
17,study7Line,16.0,51,37,1411,37,stackbar,set1,0,0,True,-3.0,12,0,start0,aligned
17,study7Line,6.0,52,20,1412,20,stackbar,set4,0,0,True,-3.0,5,5,non-aligned,non-aligned
17,study7Line,3.0,53,55,1413,35,stackbar,set2,20,20,False,4.330916878114617,10,3,non-aligned,non-aligned
17,study7Line,4.0,54,30,1414,28,stackbar,set2,2,2,False,1.0874628412503393,3,0,start0,aligned
17,study7Line,10.0,55,40,1415,40,stackbar,set4,0,0,True,-3.0,10,2,non-aligned,non-aligned
17,study7Line,3.0,56,30,1416,27,stackbar,set3,3,3,False,1.6438561897747246,2,0,start0,aligned
17,study7Line,7.0,57,45,1417,43,stackbar,set1,2,2,False,1.0874628412503393,7,2,non-aligned,non-aligned
17,study7Line,3.0,58,30,1418,30,stackbar,set3,0,0,True,-3.0,5,0,start0,aligned
17,study7Line,6.0,59,20,1419,20,stackbar,set2,0,0,True,-3.0,5,0,start0,aligned
17,study7Line,6.0,60,45,1420,43,stackbar,set2,2,2,False,1.0874628412503393,7,0,start0,aligned
17,study7Line,10.0,61,40,1421,36,stackbar,set4,4,4,False,2.0443941193584534,11,3,non-aligned,non-aligned
17,study7Line,9.0,62,30,1422,38,stackbar,set4,-8,8,False,3.0223678130284544,12,6,non-aligned,non-aligned
17,study7Line,3.0,63,35,1423,34,stackbar,set3,1,1,False,0.16992500144231237,9,0,start0,aligned
17,study7Line,4.0,64,25,1424,26,stackbar,set1,-1,1,False,0.16992500144231237,1,3,non-aligned,non-aligned
17,study7Line,3.0,65,10,1425,11,stackbar,set1,-1,1,False,0.16992500144231237,11,0,start0,aligned
17,study7Line,7.0,66,20,1426,19,stackbar,set2,1,1,False,0.16992500144231237,6,0,start0,aligned
17,study7Line,6.0,67,22,1427,22,stackbar,set4,0,0,True,-3.0,3,0,start0,aligned
17,study7Line,4.0,68,24,1428,23,stackbar,set2,1,1,False,0.16992500144231237,2,0,start0,aligned
17,study7Line,5.0,69,40,1429,40,stackbar,set3,0,0,True,-3.0,10,0,start0,aligned
17,study7Line,4.0,70,50,1430,50,stackbar,set2,0,0,True,-3.0,0,0,start0,aligned
17,study7Line,5.0,71,48,1431,48,stackbar,set1,0,0,True,-3.0,2,0,start0,aligned
17,study7Line,6.0,72,20,1432,23,stackbar,set1,-3,3,False,1.6438561897747246,2,3,non-aligned,non-aligned
17,study7Line,4.0,73,40,1433,37,stackbar,set1,3,3,False,1.6438561897747246,12,6,non-aligned,non-aligned
17,study7Line,4.0,74,26,1434,26,stackbar,set4,0,0,True,-3.0,1,0,start0,aligned
17,study7Line,4.0,75,45,1435,44,stackbar,set2,1,1,False,0.16992500144231237,6,0,start0,aligned
17,study7Line,7.0,76,15,1436,11,stackbar,set4,4,4,False,2.0443941193584534,11,4,non-aligned,non-aligned
17,study7Line,3.0,77,24,1437,24,stackbar,set1,0,0,True,-3.0,1,0,start0,aligned
17,study7Line,7.0,78,24,1438,22,stackbar,set3,2,2,False,1.0874628412503393,3,2,non-aligned,non-aligned
17,study7Line,10.0,79,38,1439,38,stackbar,set4,0,0,True,-3.0,12,0,start0,aligned
0,study7Line,9.0,0,23,0,23,stackbar,set3,0,0,True,-3.0,2,0,start0,aligned
0,study7Line,7.0,1,37,1,38,stackbar,set1,-1,1,False,0.16992500144231237,12,0,start0,aligned
0,study7Line,6.0,2,11,2,11,stackbar,set1,0,0,True,-3.0,11,0,start0,aligned
0,study7Line,6.0,3,24,3,24,stackbar,set1,0,0,True,-3.0,1,0,start0,aligned
0,study7Line,5.0,4,29,4,28,stackbar,set3,1,1,False,0.16992500144231237,3,0,start0,aligned
0,study7Line,7.0,5,12,5,14,stackbar,set3,-2,2,False,1.0874628412503393,11,2,non-aligned,non-aligned
0,study7Line,6.0,6,12,6,12,stackbar,set1,0,0,True,-3.0,12,0,start0,aligned
0,study7Line,5.0,7,42,7,43,stackbar,set2,-1,1,False,0.16992500144231237,7,0,start0,aligned
0,study7Line,5.0,8,24,8,24,stackbar,set1,0,0,True,-3.0,1,5,non-aligned,non-aligned
0,study7Line,5.0,9,18,9,17,stackbar,set2,1,1,False,0.16992500144231237,8,0,start0,aligned
0,study7Line,4.0,10,33,10,35,stackbar,set3,-2,2,False,1.0874628412503393,10,0,start0,aligned
0,study7Line,7.0,11,17,11,16,stackbar,set3,1,1,False,0.16992500144231237,9,0,start0,aligned
0,study7Line,5.0,12,19,12,18,stackbar,set4,1,1,False,0.16992500144231237,7,0,start0,aligned
0,study7Line,4.0,13,20,13,20,stackbar,set1,0,0,True,-3.0,5,0,start0,aligned
0,study7Line,7.0,14,36,14,36,stackbar,set2,0,0,True,-3.0,11,0,start0,aligned
0,study7Line,10.0,15,45,15,43,stackbar,set1,2,2,False,1.0874628412503393,7,2,non-aligned,non-aligned
0,study7Line,9.0,16,35,16,35,stackbar,set2,0,0,True,-3.0,10,3,non-aligned,non-aligned
0,study7Line,7.0,17,15,17,15,stackbar,set4,0,0,True,-3.0,10,0,start0,aligned
0,study7Line,4.0,18,13,18,14,stackbar,set1,-1,1,False,0.16992500144231237,11,0,start0,aligned
0,study7Line,6.0,19,37,19,37,stackbar,set2,0,0,True,-3.0,12,0,start0,aligned
0,study7Line,6.0,20,38,20,39,stackbar,set4,-1,1,False,0.16992500144231237,11,1,non-aligned,non-aligned
0,study7Line,4.0,21,42,21,44,stackbar,set3,-2,2,False,1.0874628412503393,6,0,start0,aligned
0,study7Line,8.0,22,50,22,46,stackbar,set1,4,4,False,2.0443941193584534,4,6,non-aligned,non-aligned
0,study7Line,5.0,23,31,23,31,stackbar,set4,0,0,True,-3.0,6,0,start0,aligned
0,study7Line,7.0,24,28,24,28,stackbar,set3,0,0,True,-3.0,3,9,non-aligned,non-aligned
0,study7Line,7.0,25,20,25,20,stackbar,set2,0,0,True,-3.0,5,0,start75,aligned
0,study7Line,7.0,26,49,26,47,stackbar,set3,2,2,False,1.0874628412503393,3,10,non-aligned,non-aligned
0,study7Line,6.0,27,29,27,29,stackbar,set1,0,0,True,-3.0,4,0,start0,aligned
0,study7Line,7.0,28,25,28,30,stackbar,set3,-5,5,False,2.357552004618084,5,7,non-aligned,non-aligned
0,study7Line,5.0,29,47,29,48,stackbar,set4,-1,1,False,0.16992500144231237,2,2,non-aligned,non-aligned
0,study7Line,4.0,30,32,30,33,stackbar,set1,-1,1,False,0.16992500144231237,8,0,start0,aligned
0,study7Line,5.0,31,30,31,32,stackbar,set2,-2,2,False,1.0874628412503393,7,6,non-aligned,non-aligned
0,study7Line,5.0,32,30,32,30,stackbar,set3,0,0,True,-3.0,5,0,start0,aligned
0,study7Line,9.0,33,40,33,40,stackbar,set4,0,0,True,-3.0,10,2,non-aligned,non-aligned
0,study7Line,4.0,34,20,34,21,stackbar,set3,-1,1,False,0.16992500144231237,4,0,start0,aligned
0,study7Line,4.0,35,20,35,27,stackbar,set2,-7,7,False,2.8328900141647417,2,11,non-aligned,non-aligned
0,study7Line,5.0,36,42,36,44,stackbar,set1,-2,2,False,1.0874628412503393,6,2,non-aligned,non-aligned
0,study7Line,4.0,37,46,37,46,stackbar,set2,0,0,True,-3.0,4,0,start0,aligned
0,study7Line,8.0,38,43,38,42,stackbar,set1,1,1,False,0.16992500144231237,8,3,non-aligned,non-aligned
0,study7Line,5.0,39,32,39,32,stackbar,set2,0,0,True,-3.0,7,0,start0,aligned
0,study7Line,4.0,40,25,40,33,stackbar,set2,-8,8,False,3.0223678130284544,8,8,non-aligned,non-aligned
0,study7Line,4.0,41,20,41,21,stackbar,set1,-1,1,False,0.16992500144231237,4,1,non-aligned,non-aligned
0,study7Line,4.0,42,18,42,25,stackbar,set1,-7,7,False,2.8328900141647417,0,7,non-aligned,non-aligned
0,study7Line,4.0,43,10,43,12,stackbar,set4,-2,2,False,1.0874628412503393,12,6,non-aligned,non-aligned
0,study7Line,4.0,44,27,44,34,stackbar,set2,-7,7,False,2.8328900141647417,9,2,non-aligned,non-aligned
0,study7Line,5.0,45,41,45,42,stackbar,set4,-1,1,False,0.16992500144231237,8,0,start0,aligned
0,study7Line,7.0,46,49,46,49,stackbar,set4,0,0,True,-3.0,1,5,non-aligned,non-aligned
0,study7Line,3.0,47,21,47,19,stackbar,set4,2,2,False,1.0874628412503393,6,0,start0,aligned
0,study7Line,5.0,48,29,48,38,stackbar,set4,-9,9,False,3.189824558880017,12,6,non-aligned,non-aligned
0,study7Line,4.0,49,26,49,26,stackbar,set4,0,0,True,-3.0,1,1,non-aligned,non-aligned
0,study7Line,6.0,50,24,50,22,stackbar,set2,2,2,False,1.0874628412503393,3,9,non-aligned,non-aligned
0,study7Line,4.0,51,13,51,13,stackbar,set3,0,0,True,-3.0,12,0,start0,aligned
0,study7Line,4.0,52,23,52,23,stackbar,set1,0,0,True,-3.0,2,3,non-aligned,non-aligned
0,study7Line,8.0,53,19,53,19,stackbar,set4,0,0,True,-3.0,6,0,end75,aligned
0,study7Line,6.0,54,36,54,37,stackbar,set4,-1,1,False,0.16992500144231237,12,1,non-aligned,non-aligned
0,study7Line,6.0,55,51,55,50,stackbar,set1,1,1,False,0.16992500144231237,0,6,non-aligned,non-aligned
0,study7Line,4.0,56,32,56,34,stackbar,set2,-2,2,False,1.0874628412503393,9,0,start0,aligned
0,study7Line,5.0,57,48,57,48,stackbar,set3,0,0,True,-3.0,2,0,start0,aligned
0,study7Line,6.0,58,49,58,49,stackbar,set3,0,0,True,-3.0,1,0,start0,aligned
0,study7Line,7.0,59,68,59,18,stackbar,set2,50,50,False,5.647458426454921,7,1,non-aligned,non-aligned
0,study7Line,5.0,60,31,60,31,stackbar,set3,0,0,True,-3.0,6,2,non-aligned,non-aligned
0,study7Line,4.0,61,50,61,50,stackbar,set2,0,0,True,-3.0,0,0,start0,aligned
0,study7Line,5.0,62,22,62,22,stackbar,set4,0,0,True,-3.0,3,0,start0,aligned
0,study7Line,8.0,63,35,63,36,stackbar,set1,-1,1,False,0.16992500144231237,11,3,non-aligned,non-aligned
0,study7Line,3.0,64,25,64,25,stackbar,set3,0,0,True,-3.0,0,0,start0,aligned
0,study7Line,8.0,65,12,65,13,stackbar,set3,-1,1,False,0.16992500144231237,12,2,non-aligned,non-aligned
0,study7Line,8.0,66,10,66,15,stackbar,set4,-5,5,False,2.357552004618084,10,4,non-aligned,non-aligned
0,study7Line,4.0,67,25,67,29,stackbar,set3,-4,4,False,2.0443941193584534,4,9,non-aligned,non-aligned
0,study7Line,4.0,68,37,68,39,stackbar,set3,-2,2,False,1.0874628412503393,11,0,start0,aligned
0,study7Line,4.0,69,46,69,47,stackbar,set2,-1,1,False,0.16992500144231237,3,0,start0,aligned
0,study7Line,3.0,70,26,70,26,stackbar,set3,0,0,True,-3.0,1,0,start0,aligned
0,study7Line,5.0,71,43,71,41,stackbar,set4,2,2,False,1.0874628412503393,9,4,non-aligned,non-aligned
0,study7Line,5.0,72,39,72,40,stackbar,set1,-1,1,False,0.16992500144231237,10,0,start0,aligned
0,study7Line,5.0,73,27,73,27,stackbar,set4,0,0,True,-3.0,2,0,start0,aligned
0,study7Line,4.0,74,45,74,45,stackbar,set4,0,0,True,-3.0,5,0,start0,aligned
0,study7Line,4.0,75,16,75,16,stackbar,set3,0,0,True,-3.0,9,3,non-aligned,non-aligned
0,study7Line,4.0,76,45,76,45,stackbar,set3,0,0,True,-3.0,5,7,non-aligned,non-aligned
0,study7Line,5.0,77,40,77,41,stackbar,set3,-1,1,False,0.16992500144231237,9,0,start0,aligned
0,study7Line,5.0,78,9,78,11,stackbar,set4,-2,2,False,1.0874628412503393,11,4,non-aligned,non-aligned
0,study7Line,6.0,79,16,79,17,stackbar,set4,-1,1,False,0.16992500144231237,8,1,non-aligned,non-aligned
39,study7Line,16.0,0,9,3120,11,stackbar,set2,-2,2,False,1.0874628412503393,11,0,start0,aligned
39,study7Line,14.0,1,40,3121,37,stackbar,set4,3,3,False,1.6438561897747246,12,1,non-aligned,non-aligned
39,study7Line,25.0,2,30,3122,30,stackbar,set4,0,0,True,-3.0,5,1,non-aligned,non-aligned
39,study7Line,21.0,3,20,3123,22,stackbar,set4,-2,2,False,1.0874628412503393,3,0,start0,aligned
39,study7Line,13.0,4,30,3124,32,stackbar,set1,-2,2,False,1.0874628412503393,7,0,start0,aligned
39,study7Line,11.0,5,30,3125,30,stackbar,set3,0,0,True,-3.0,5,0,start0,aligned
39,study7Line,19.0,6,40,3126,47,stackbar,set3,-7,7,False,2.8328900141647417,3,10,non-aligned,non-aligned
39,study7Line,21.0,7,15,3127,17,stackbar,set1,-2,2,False,1.0874628412503393,8,0,start0,aligned
39,study7Line,31.0,8,42,3128,44,stackbar,set4,-2,2,False,1.0874628412503393,6,2,non-aligned,non-aligned
39,study7Line,27.0,9,35,3129,37,stackbar,set1,-2,2,False,1.0874628412503393,12,0,start0,aligned
39,study7Line,15.0,10,20,3130,17,stackbar,set4,3,3,False,1.6438561897747246,8,1,non-aligned,non-aligned
39,study7Line,14.0,11,11,3131,15,stackbar,set4,-4,4,False,2.0443941193584534,10,0,start0,aligned
39,study7Line,23.0,12,25,3132,27,stackbar,set2,-2,2,False,1.0874628412503393,2,11,non-aligned,non-aligned
39,study7Line,18.0,13,40,3133,43,stackbar,set4,-3,3,False,1.6438561897747246,7,6,non-aligned,non-aligned
39,study7Line,16.0,14,40,3134,43,stackbar,set3,-3,3,False,1.6438561897747246,7,0,start0,aligned
39,study7Line,23.0,15,42,3135,41,stackbar,set4,1,1,False,0.16992500144231237,9,0,start0,aligned
39,study7Line,36.0,16,42,3136,46,stackbar,set1,-4,4,False,2.0443941193584534,4,6,non-aligned,non-aligned
39,study7Line,23.0,17,18,3137,16,stackbar,set4,2,2,False,1.0874628412503393,9,3,non-aligned,non-aligned
39,study7Line,16.0,18,27,3138,26,stackbar,set3,1,1,False,0.16992500144231237,1,0,start0,aligned
39,study7Line,26.0,19,50,3139,50,stackbar,set3,0,0,True,-3.0,0,5,non-aligned,non-aligned
39,study7Line,14.0,20,12,3140,14,stackbar,set2,-2,2,False,1.0874628412503393,11,0,start0,aligned
39,study7Line,28.0,21,21,3141,26,stackbar,set4,-5,5,False,2.357552004618084,1,1,non-aligned,non-aligned
39,study7Line,17.0,22,14,3142,16,stackbar,set4,-2,2,False,1.0874628412503393,9,0,start0,aligned
39,study7Line,26.0,23,20,3143,18,stackbar,set2,2,2,False,1.0874628412503393,7,1,non-aligned,non-aligned
39,study7Line,13.0,24,22,3144,27,stackbar,set2,-5,5,False,2.357552004618084,2,0,start0,aligned
39,study7Line,77.0,25,32,3145,34,stackbar,set2,-2,2,False,1.0874628412503393,9,0,start0,aligned
39,study7Line,10.0,26,40,3146,46,stackbar,set1,-6,6,False,2.6147098441152083,4,0,start0,aligned
39,study7Line,16.0,27,45,3147,48,stackbar,set3,-3,3,False,1.6438561897747246,2,2,non-aligned,non-aligned
39,study7Line,40.0,28,24,3148,29,stackbar,set1,-5,5,False,2.357552004618084,4,2,non-aligned,non-aligned
39,study7Line,9.0,29,37,3149,38,stackbar,set1,-1,1,False,0.16992500144231237,12,0,start0,aligned
39,study7Line,18.0,30,10,3150,11,stackbar,set3,-1,1,False,0.16992500144231237,11,5,non-aligned,non-aligned
39,study7Line,16.0,31,43,3151,40,stackbar,set4,3,3,False,1.6438561897747246,10,2,non-aligned,non-aligned
39,study7Line,12.0,32,45,3152,45,stackbar,set2,0,0,True,-3.0,5,9,non-aligned,non-aligned
39,study7Line,31.0,33,47,3153,47,stackbar,set1,0,0,True,-3.0,3,0,start0,aligned
39,study7Line,9.0,34,46,3154,48,stackbar,set3,-2,2,False,1.0874628412503393,2,0,start0,aligned
39,study7Line,15.0,35,11,3155,13,stackbar,set2,-2,2,False,1.0874628412503393,12,0,start0,aligned
39,study7Line,11.0,36,27,3156,28,stackbar,set3,-1,1,False,0.16992500144231237,3,0,start0,aligned
39,study7Line,15.0,37,33,3157,33,stackbar,set3,0,0,True,-3.0,8,3,non-aligned,non-aligned
39,study7Line,19.0,38,40,3158,40,stackbar,set3,0,0,True,-3.0,10,0,start0,aligned
39,study7Line,13.0,39,29,3159,31,stackbar,set4,-2,2,False,1.0874628412503393,6,0,end50,aligned
39,study7Line,16.0,40,35,3160,35,stackbar,set2,0,0,True,-3.0,10,3,non-aligned,non-aligned
39,study7Line,31.0,41,28,3161,34,stackbar,set1,-6,6,False,2.6147098441152083,9,6,non-aligned,non-aligned
39,study7Line,15.0,42,38,3162,39,stackbar,set4,-1,1,False,0.16992500144231237,11,1,non-aligned,non-aligned
39,study7Line,9.0,43,36,3163,35,stackbar,set1,1,1,False,0.16992500144231237,10,0,start0,aligned
39,study7Line,15.0,44,39,3164,42,stackbar,set3,-3,3,False,1.6438561897747246,8,0,start0,aligned
39,study7Line,12.0,45,14,3165,18,stackbar,set3,-4,4,False,2.0443941193584534,7,0,start0,aligned
39,study7Line,13.0,46,22,3166,22,stackbar,set4,0,0,True,-3.0,3,0,start75,aligned
39,study7Line,24.0,47,38,3167,41,stackbar,set1,-3,3,False,1.6438561897747246,9,6,non-aligned,non-aligned
39,study7Line,13.0,48,20,3168,19,stackbar,set3,1,1,False,0.16992500144231237,6,1,non-aligned,non-aligned
39,study7Line,28.0,49,43,3169,44,stackbar,set1,-1,1,False,0.16992500144231237,6,0,start0,aligned
39,study7Line,8.0,50,24,3170,24,stackbar,set4,0,0,True,-3.0,1,0,start0,aligned
39,study7Line,14.0,51,21,3171,20,stackbar,set3,1,1,False,0.16992500144231237,5,0,start0,aligned
39,study7Line,11.0,52,13,3172,12,stackbar,set1,1,1,False,0.16992500144231237,12,1,non-aligned,non-aligned
39,study7Line,11.0,53,35,3173,31,stackbar,set4,4,4,False,2.0443941193584534,6,0,start0,aligned
39,study7Line,10.0,54,13,3174,13,stackbar,set3,0,0,True,-3.0,12,2,non-aligned,non-aligned
39,study7Line,19.0,55,45,3175,49,stackbar,set4,-4,4,False,2.0443941193584534,1,5,non-aligned,non-aligned
39,study7Line,13.0,56,43,3176,39,stackbar,set3,4,4,False,2.0443941193584534,11,0,start0,aligned
39,study7Line,40.0,57,27,3177,24,stackbar,set1,3,3,False,1.6438561897747246,1,5,non-aligned,non-aligned
39,study7Line,14.0,58,48,3178,49,stackbar,set3,-1,1,False,0.16992500144231237,1,0,start0,aligned
39,study7Line,32.0,59,30,3179,32,stackbar,set2,-2,2,False,1.0874628412503393,7,6,non-aligned,non-aligned
39,study7Line,14.0,60,20,3180,20,stackbar,set1,0,0,True,-3.0,5,0,start75,aligned
39,study7Line,23.0,61,17,3181,14,stackbar,set4,3,3,False,1.6438561897747246,11,6,non-aligned,non-aligned
39,study7Line,25.0,62,27,3182,28,stackbar,set1,-1,1,False,0.16992500144231237,3,10,non-aligned,non-aligned
39,study7Line,7.0,63,20,3183,19,stackbar,set1,1,1,False,0.16992500144231237,6,0,start0,aligned
39,study7Line,12.0,64,28,3184,25,stackbar,set3,3,3,False,1.6438561897747246,0,5,non-aligned,non-aligned
39,study7Line,12.0,65,47,3185,38,stackbar,set1,9,9,False,3.189824558880017,12,1,non-aligned,non-aligned
39,study7Line,19.0,66,25,3186,23,stackbar,set3,2,2,False,1.0874628412503393,2,10,non-aligned,non-aligned
39,study7Line,21.0,67,43,3187,42,stackbar,set2,1,1,False,0.16992500144231237,8,4,non-aligned,non-aligned
39,study7Line,21.0,68,28,3188,29,stackbar,set2,-1,1,False,0.16992500144231237,4,0,start0,aligned
39,study7Line,11.0,69,35,3189,36,stackbar,set2,-1,1,False,0.16992500144231237,11,1,non-aligned,non-aligned
39,study7Line,24.0,70,8,3190,12,stackbar,set3,-4,4,False,2.0443941193584534,12,0,start0,aligned
39,study7Line,16.0,71,22,3191,21,stackbar,set3,1,1,False,0.16992500144231237,4,2,non-aligned,non-aligned
39,study7Line,14.0,72,25,3192,25,stackbar,set1,0,0,True,-3.0,0,0,start0,aligned
39,study7Line,12.0,73,23,3193,23,stackbar,set4,0,0,True,-3.0,2,0,start0,aligned
39,study7Line,8.0,74,50,3194,50,stackbar,set4,0,0,True,-3.0,0,0,start0,aligned
39,study7Line,13.0,75,48,3195,45,stackbar,set4,3,3,False,1.6438561897747246,5,0,start0,aligned
39,study7Line,16.0,76,13,3196,15,stackbar,set1,-2,2,False,1.0874628412503393,10,5,non-aligned,non-aligned
39,study7Line,13.0,77,21,3197,21,stackbar,set1,0,0,True,-3.0,4,0,start0,aligned
39,study7Line,11.0,78,33,3198,33,stackbar,set2,0,0,True,-3.0,8,0,start0,aligned
39,study7Line,19.0,79,35,3199,36,stackbar,set2,-1,1,False,0.16992500144231237,11,0,start0,aligned
3,study7Line,9.0,0,40,240,41,stackbar,set2,-1,1,False,0.16992500144231237,9,4,non-aligned,non-aligned
3,study7Line,12.0,1,45,241,42,stackbar,set1,3,3,False,1.6438561897747246,8,0,start0,aligned
3,study7Line,14.0,2,40,242,39,stackbar,set1,1,1,False,0.16992500144231237,11,4,non-aligned,non-aligned
3,study7Line,9.0,3,30,243,33,stackbar,set3,-3,3,False,1.6438561897747246,8,0,start0,aligned
3,study7Line,7.0,4,20,244,22,stackbar,set1,-2,2,False,1.0874628412503393,3,0,start0,aligned
3,study7Line,8.0,5,35,245,38,stackbar,set1,-3,3,False,1.6438561897747246,12,0,start0,aligned
3,study7Line,6.0,6,40,246,41,stackbar,set2,-1,1,False,0.16992500144231237,9,0,start0,aligned
3,study7Line,6.0,7,20,247,20,stackbar,set3,0,0,True,-3.0,5,0,start0,aligned
3,study7Line,6.0,8,15,248,17,stackbar,set1,-2,2,False,1.0874628412503393,8,0,start0,aligned
3,study7Line,21.0,9,39,249,30,stackbar,set4,9,9,False,3.189824558880017,5,1,non-aligned,non-aligned
3,study7Line,9.0,10,20,250,21,stackbar,set2,-1,1,False,0.16992500144231237,4,0,start0,aligned
3,study7Line,7.0,11,30,251,28,stackbar,set2,2,2,False,1.0874628412503393,3,8,non-aligned,non-aligned
3,study7Line,9.0,12,10,252,15,stackbar,set1,-5,5,False,2.357552004618084,10,5,non-aligned,non-aligned
3,study7Line,12.0,13,50,253,50,stackbar,set4,0,0,True,-3.0,0,7,non-aligned,non-aligned
3,study7Line,11.0,14,47,254,48,stackbar,set4,-1,1,False,0.16992500144231237,2,2,non-aligned,non-aligned
3,study7Line,7.0,15,20,255,19,stackbar,set2,1,1,False,0.16992500144231237,6,0,start0,aligned
3,study7Line,8.0,16,35,256,35,stackbar,set1,0,0,True,-3.0,10,0,start0,aligned
3,study7Line,14.0,17,38,257,37,stackbar,set3,1,1,False,0.16992500144231237,12,0,start0,aligned
3,study7Line,21.0,18,43,258,40,stackbar,set4,3,3,False,1.6438561897747246,10,2,non-aligned,non-aligned
3,study7Line,7.0,19,20,259,18,stackbar,set4,2,2,False,1.0874628412503393,7,0,start0,aligned
3,study7Line,8.0,20,40,260,42,stackbar,set2,-2,2,False,1.0874628412503393,8,4,non-aligned,non-aligned
3,study7Line,7.0,21,27,261,27,stackbar,set2,0,0,True,-3.0,2,0,start0,aligned
3,study7Line,5.0,22,24,262,24,stackbar,set1,0,0,True,-3.0,1,0,start0,aligned
3,study7Line,4.0,23,28,263,28,stackbar,set1,0,0,True,-3.0,3,0,start0,aligned
3,study7Line,7.0,24,48,264,49,stackbar,set3,-1,1,False,0.16992500144231237,1,0,start0,aligned
3,study7Line,11.0,25,22,265,20,stackbar,set4,2,2,False,1.0874628412503393,5,5,non-aligned,non-aligned
3,study7Line,13.0,26,25,266,24,stackbar,set1,1,1,False,0.16992500144231237,1,5,non-aligned,non-aligned
3,study7Line,9.0,27,45,267,45,stackbar,set2,0,0,True,-3.0,5,9,non-aligned,non-aligned
3,study7Line,11.0,28,32,268,34,stackbar,set4,-2,2,False,1.0874628412503393,9,2,non-aligned,non-aligned
3,study7Line,5.0,29,10,269,13,stackbar,set2,-3,3,False,1.6438561897747246,12,0,start0,aligned
3,study7Line,4.0,30,10,270,11,stackbar,set3,-1,1,False,0.16992500144231237,11,0,start0,aligned
3,study7Line,6.0,31,18,271,16,stackbar,set2,2,2,False,1.0874628412503393,9,0,start0,aligned
3,study7Line,11.0,32,60,272,12,stackbar,set3,48,48,False,5.588714635582264,12,1,non-aligned,non-aligned
3,study7Line,11.0,33,48,273,48,stackbar,set1,0,0,True,-3.0,2,0,start0,aligned
3,study7Line,4.0,34,15,274,14,stackbar,set2,1,1,False,0.16992500144231237,11,0,start0,aligned
3,study7Line,5.0,35,10,275,12,stackbar,set2,-2,2,False,1.0874628412503393,12,0,start0,aligned
3,study7Line,13.0,36,15,276,11,stackbar,set1,4,4,False,2.0443941193584534,11,4,non-aligned,non-aligned
3,study7Line,7.0,37,47,277,45,stackbar,set1,2,2,False,1.0874628412503393,5,0,start0,aligned
3,study7Line,13.0,38,40,278,43,stackbar,set2,-3,3,False,1.6438561897747246,7,0,start0,aligned
3,study7Line,8.0,39,39,279,37,stackbar,set4,2,2,False,1.0874628412503393,12,1,non-aligned,non-aligned
3,study7Line,7.0,40,35,280,33,stackbar,set1,2,2,False,1.0874628412503393,8,6,non-aligned,non-aligned
3,study7Line,5.0,41,30,281,29,stackbar,set4,1,1,False,0.16992500144231237,4,0,start0,aligned
3,study7Line,4.0,42,40,282,40,stackbar,set1,0,0,True,-3.0,10,0,start0,aligned
3,study7Line,9.0,43,35,283,31,stackbar,set1,4,4,False,2.0443941193584534,6,4,non-aligned,non-aligned
3,study7Line,7.0,44,15,284,13,stackbar,set4,2,2,False,1.0874628412503393,12,6,non-aligned,non-aligned
3,study7Line,8.0,45,38,285,35,stackbar,set2,3,3,False,1.6438561897747246,10,3,non-aligned,non-aligned
3,study7Line,11.0,46,30,286,29,stackbar,set1,1,1,False,0.16992500144231237,4,2,non-aligned,non-aligned
3,study7Line,10.0,47,33,287,43,stackbar,set1,-10,10,False,3.3398500028846247,7,2,non-aligned,non-aligned
3,study7Line,8.0,48,38,288,39,stackbar,set4,-1,1,False,0.16992500144231237,11,0,start0,aligned
3,study7Line,5.0,49,35,289,32,stackbar,set2,3,3,False,1.6438561897747246,7,0,start0,aligned
3,study7Line,12.0,50,22,290,21,stackbar,set3,1,1,False,0.16992500144231237,4,2,non-aligned,non-aligned
3,study7Line,7.0,51,12,291,14,stackbar,set3,-2,2,False,1.0874628412503393,11,2,non-aligned,non-aligned
3,study7Line,11.0,52,50,292,46,stackbar,set2,4,4,False,2.0443941193584534,4,9,non-aligned,non-aligned
3,study7Line,5.0,53,26,293,26,stackbar,set2,0,0,True,-3.0,1,0,start0,aligned
3,study7Line,8.0,54,50,294,50,stackbar,set3,0,0,True,-3.0,0,0,start0,aligned
3,study7Line,7.0,55,46,295,46,stackbar,set2,0,0,True,-3.0,4,0,start0,aligned
3,study7Line,6.0,56,35,296,34,stackbar,set1,1,1,False,0.16992500144231237,9,0,start0,aligned
3,study7Line,4.0,57,25,297,25,stackbar,set3,0,0,True,-3.0,0,0,start0,aligned
3,study7Line,30.0,58,28,298,26,stackbar,set3,2,2,False,1.0874628412503393,1,3,non-aligned,non-aligned
3,study7Line,13.0,59,45,299,47,stackbar,set3,-2,2,False,1.0874628412503393,3,10,non-aligned,non-aligned
3,study7Line,11.0,60,31,300,31,stackbar,set1,0,0,True,-3.0,6,0,start0,aligned
3,study7Line,9.0,61,37,301,36,stackbar,set3,1,1,False,0.16992500144231237,11,0,start0,aligned
3,study7Line,6.0,62,15,302,15,stackbar,set4,0,0,True,-3.0,10,0,start0,aligned
3,study7Line,9.0,63,32,303,38,stackbar,set1,-6,6,False,2.6147098441152083,12,1,non-aligned,non-aligned
3,study7Line,10.0,64,25,304,32,stackbar,set2,-7,7,False,2.8328900141647417,7,6,non-aligned,non-aligned
3,study7Line,15.0,65,22,305,22,stackbar,set1,0,0,True,-3.0,3,2,non-aligned,non-aligned
3,study7Line,6.0,66,30,306,25,stackbar,set1,5,5,False,2.357552004618084,0,7,non-aligned,non-aligned
3,study7Line,6.0,67,44,307,44,stackbar,set2,0,0,True,-3.0,6,0,start0,aligned
3,study7Line,5.0,68,30,308,30,stackbar,set4,0,0,True,-3.0,5,0,start0,aligned
3,study7Line,7.0,69,43,309,36,stackbar,set1,7,7,False,2.8328900141647417,11,3,non-aligned,non-aligned
3,study7Line,8.0,70,43,310,44,stackbar,set4,-1,1,False,0.16992500144231237,6,2,non-aligned,non-aligned
3,study7Line,5.0,71,23,311,23,stackbar,set1,0,0,True,-3.0,2,0,start0,aligned
3,study7Line,12.0,72,28,312,27,stackbar,set2,1,1,False,0.16992500144231237,2,11,non-aligned,non-aligned
3,study7Line,8.0,73,45,313,49,stackbar,set4,-4,4,False,2.0443941193584534,1,5,non-aligned,non-aligned
3,study7Line,12.0,74,18,314,23,stackbar,set4,-5,5,False,2.357552004618084,2,10,non-aligned,non-aligned
3,study7Line,11.0,75,15,315,17,stackbar,set3,-2,2,False,1.0874628412503393,8,3,non-aligned,non-aligned
3,study7Line,11.0,76,17,316,16,stackbar,set2,1,1,False,0.16992500144231237,9,2,non-aligned,non-aligned
3,study7Line,7.0,77,11,317,18,stackbar,set1,-7,7,False,2.8328900141647417,7,1,non-aligned,non-aligned
3,study7Line,6.0,78,19,318,19,stackbar,set3,0,0,True,-3.0,6,1,non-aligned,non-aligned
3,study7Line,6.0,79,47,319,47,stackbar,set2,0,0,True,-3.0,3,0,start0,aligned
30,study7Line,13.0,0,40,2400,40,stackbar,set4,0,0,True,-3.0,10,0,start0,aligned
30,study7Line,21.0,1,40,2401,41,stackbar,set2,-1,1,False,0.16992500144231237,9,4,non-aligned,non-aligned
30,study7Line,12.0,2,30,2402,33,stackbar,set2,-3,3,False,1.6438561897747246,8,0,start0,aligned
30,study7Line,7.0,3,27,2403,27,stackbar,set1,0,0,True,-3.0,2,0,start0,aligned
30,study7Line,8.0,4,26,2404,26,stackbar,set1,0,0,True,-3.0,1,0,start0,aligned
30,study7Line,6.0,5,30,2405,31,stackbar,set1,-1,1,False,0.16992500144231237,6,0,start0,aligned
30,study7Line,18.0,6,32,2406,32,stackbar,set1,0,0,True,-3.0,7,2,non-aligned,non-aligned
30,study7Line,11.0,7,38,2407,36,stackbar,set2,2,2,False,1.0874628412503393,11,0,start0,aligned
30,study7Line,6.0,8,30,2408,30,stackbar,set2,0,0,True,-3.0,5,0,start0,aligned
30,study7Line,14.0,9,35,2409,35,stackbar,set4,0,0,True,-3.0,10,0,end100,aligned
30,study7Line,8.0,10,25,2410,25,stackbar,set3,0,0,True,-3.0,0,5,non-aligned,non-aligned
30,study7Line,11.0,11,18,2411,18,stackbar,set3,0,0,True,-3.0,7,2,non-aligned,non-aligned
30,study7Line,12.0,12,45,2412,46,stackbar,set3,-1,1,False,0.16992500144231237,4,10,non-aligned,non-aligned
30,study7Line,18.0,13,20,2413,19,stackbar,set2,1,1,False,0.16992500144231237,6,0,start0,aligned
30,study7Line,20.0,14,46,2414,40,stackbar,set4,6,6,False,2.6147098441152083,10,2,non-aligned,non-aligned
30,study7Line,17.0,15,10,2415,12,stackbar,set1,-2,2,False,1.0874628412503393,12,0,start0,aligned
30,study7Line,9.0,16,26,2416,28,stackbar,set2,-2,2,False,1.0874628412503393,3,8,non-aligned,non-aligned
30,study7Line,11.0,17,40,2417,39,stackbar,set3,1,1,False,0.16992500144231237,11,0,start0,aligned
30,study7Line,16.0,18,23,2418,13,stackbar,set3,10,10,False,3.3398500028846247,12,2,non-aligned,non-aligned
30,study7Line,94.0,19,23,2419,14,stackbar,set1,9,9,False,3.189824558880017,11,5,non-aligned,non-aligned
30,study7Line,10.0,20,20,2420,15,stackbar,set3,5,5,False,2.357552004618084,10,3,non-aligned,non-aligned
30,study7Line,7.0,21,30,2421,34,stackbar,set2,-4,4,False,2.0443941193584534,9,0,start0,aligned
30,study7Line,15.0,22,37,2422,37,stackbar,set2,0,0,True,-3.0,12,0,start0,aligned
30,study7Line,7.0,23,21,2423,21,stackbar,set2,0,0,True,-3.0,4,0,start0,aligned
30,study7Line,12.0,24,27,2424,27,stackbar,set1,0,0,True,-3.0,2,2,non-aligned,non-aligned
30,study7Line,8.0,25,34,2425,38,stackbar,set3,-4,4,False,2.0443941193584534,12,0,start0,aligned
30,study7Line,13.0,26,15,2426,15,stackbar,set3,0,0,True,-3.0,10,0,start0,aligned
30,study7Line,8.0,27,49,2427,49,stackbar,set2,0,0,True,-3.0,1,0,start0,aligned
30,study7Line,7.0,28,18,2428,16,stackbar,set2,2,2,False,1.0874628412503393,9,0,start0,aligned
30,study7Line,11.0,29,22,2429,26,stackbar,set2,-4,4,False,2.0443941193584534,1,10,non-aligned,non-aligned
30,study7Line,7.0,30,50,2430,50,stackbar,set4,0,0,True,-3.0,0,0,start0,aligned
30,study7Line,9.0,31,28,2431,31,stackbar,set1,-3,3,False,1.6438561897747246,6,4,non-aligned,non-aligned
30,study7Line,5.0,32,23,2432,22,stackbar,set1,1,1,False,0.16992500144231237,3,0,start0,aligned
30,study7Line,18.0,33,42,2433,44,stackbar,set2,-2,2,False,1.0874628412503393,6,9,non-aligned,non-aligned
30,study7Line,10.0,34,30,2434,32,stackbar,set1,-2,2,False,1.0874628412503393,7,0,start0,aligned
30,study7Line,7.0,35,28,2435,29,stackbar,set3,-1,1,False,0.16992500144231237,4,0,start0,aligned
30,study7Line,12.0,36,18,2436,11,stackbar,set2,7,7,False,2.8328900141647417,11,2,non-aligned,non-aligned
30,study7Line,7.0,37,24,2437,24,stackbar,set2,0,0,True,-3.0,1,0,start0,aligned
30,study7Line,6.0,38,20,2438,18,stackbar,set4,2,2,False,1.0874628412503393,7,0,start0,aligned
30,study7Line,4.0,39,23,2439,23,stackbar,set2,0,0,True,-3.0,2,0,start0,aligned
30,study7Line,8.0,40,32,2440,38,stackbar,set1,-6,6,False,2.6147098441152083,12,1,non-aligned,non-aligned
30,study7Line,10.0,41,50,2441,50,stackbar,set4,0,0,True,-3.0,0,7,non-aligned,non-aligned
30,study7Line,11.0,42,42,2442,44,stackbar,set2,-2,2,False,1.0874628412503393,6,0,start0,aligned
30,study7Line,10.0,43,25,2443,24,stackbar,set2,1,1,False,0.16992500144231237,1,2,non-aligned,non-aligned
30,study7Line,11.0,44,20,2444,19,stackbar,set3,1,1,False,0.16992500144231237,6,1,non-aligned,non-aligned
30,study7Line,8.0,45,25,2445,23,stackbar,set4,2,2,False,1.0874628412503393,2,10,non-aligned,non-aligned
30,study7Line,14.0,46,12,2446,12,stackbar,set3,0,0,True,-3.0,12,1,non-aligned,non-aligned
30,study7Line,11.0,47,30,2447,34,stackbar,set1,-4,4,False,2.0443941193584534,9,6,non-aligned,non-aligned
30,study7Line,16.0,48,15,2448,17,stackbar,set1,-2,2,False,1.0874628412503393,8,0,start25,aligned
30,study7Line,5.0,49,15,2449,17,stackbar,set3,-2,2,False,1.0874628412503393,8,0,start0,aligned
30,study7Line,10.0,50,45,2450,42,stackbar,set2,3,3,False,1.6438561897747246,8,4,non-aligned,non-aligned
30,study7Line,5.0,51,25,2451,25,stackbar,set4,0,0,True,-3.0,0,0,start0,aligned
30,study7Line,10.0,52,20,2452,20,stackbar,set3,0,0,True,-3.0,5,2,non-aligned,non-aligned
30,study7Line,4.0,53,12,2453,13,stackbar,set3,-1,1,False,0.16992500144231237,12,0,start0,aligned
30,study7Line,8.0,54,50,2454,45,stackbar,set2,5,5,False,2.357552004618084,5,9,non-aligned,non-aligned
30,study7Line,9.0,55,23,2455,21,stackbar,set2,2,2,False,1.0874628412503393,4,6,non-aligned,non-aligned
30,study7Line,6.0,56,46,2456,46,stackbar,set3,0,0,True,-3.0,4,0,start0,aligned
30,study7Line,7.0,57,44,2457,43,stackbar,set4,1,1,False,0.16992500144231237,7,0,start0,aligned
30,study7Line,8.0,58,47,2458,45,stackbar,set1,2,2,False,1.0874628412503393,5,0,start0,aligned
30,study7Line,6.0,59,12,2459,14,stackbar,set4,-2,2,False,1.0874628412503393,11,0,start0,aligned
30,study7Line,13.0,60,60,2460,43,stackbar,set1,17,17,False,4.098032082960526,7,2,non-aligned,non-aligned
30,study7Line,16.0,61,38,2461,39,stackbar,set4,-1,1,False,0.16992500144231237,11,1,non-aligned,non-aligned
30,study7Line,16.0,62,29,2462,33,stackbar,set1,-4,4,False,2.0443941193584534,8,6,non-aligned,non-aligned
30,study7Line,12.0,63,30,2463,35,stackbar,set2,-5,5,False,2.357552004618084,10,0,start0,aligned
30,study7Line,9.0,64,24,2464,22,stackbar,set2,2,2,False,1.0874628412503393,3,9,non-aligned,non-aligned
30,study7Line,6.0,65,46,2465,47,stackbar,set3,-1,1,False,0.16992500144231237,3,0,start0,aligned
30,study7Line,10.0,66,22,2466,29,stackbar,set3,-7,7,False,2.8328900141647417,4,9,non-aligned,non-aligned
30,study7Line,8.0,67,48,2467,48,stackbar,set4,0,0,True,-3.0,2,0,start0,aligned
30,study7Line,6.0,68,21,2468,20,stackbar,set4,1,1,False,0.16992500144231237,5,0,start0,aligned
30,study7Line,8.0,69,27,2469,30,stackbar,set3,-3,3,False,1.6438561897747246,5,7,non-aligned,non-aligned
30,study7Line,8.0,70,34,2470,37,stackbar,set3,-3,3,False,1.6438561897747246,12,0,start25,aligned
30,study7Line,7.0,71,41,2471,36,stackbar,set2,5,5,False,2.357552004618084,11,1,non-aligned,non-aligned
30,study7Line,6.0,72,27,2472,28,stackbar,set1,-1,1,False,0.16992500144231237,3,0,start0,aligned
30,study7Line,8.0,73,8,2473,11,stackbar,set1,-3,3,False,1.6438561897747246,11,0,start0,aligned
30,study7Line,7.0,74,40,2474,41,stackbar,set1,-1,1,False,0.16992500144231237,9,0,start0,aligned
30,study7Line,9.0,75,49,2475,48,stackbar,set2,1,1,False,0.16992500144231237,2,2,non-aligned,non-aligned
30,study7Line,9.0,76,49,2476,47,stackbar,set3,2,2,False,1.0874628412503393,3,10,non-aligned,non-aligned
30,study7Line,9.0,77,25,2477,16,stackbar,set2,9,9,False,3.189824558880017,9,2,non-aligned,non-aligned
30,study7Line,14.0,78,40,2478,42,stackbar,set1,-2,2,False,1.0874628412503393,8,0,start0,aligned
30,study7Line,10.0,79,50,2479,49,stackbar,set2,1,1,False,0.16992500144231237,1,8,non-aligned,non-aligned
33,study7Line,12.0,0,14,2640,14,stackbar,set3,0,0,True,-3.0,11,2,non-aligned,non-aligned
33,study7Line,20.0,1,15,2641,13,stackbar,set2,2,2,False,1.0874628412503393,12,0,start0,aligned
33,study7Line,14.0,2,28,2642,30,stackbar,set2,-2,2,False,1.0874628412503393,5,0,start0,aligned
33,study7Line,16.0,3,43,2643,41,stackbar,set4,2,2,False,1.0874628412503393,9,0,start0,aligned
33,study7Line,15.0,4,20,2644,19,stackbar,set4,1,1,False,0.16992500144231237,6,0,end75,aligned
33,study7Line,12.0,5,30,2645,31,stackbar,set3,-1,1,False,0.16992500144231237,6,2,non-aligned,non-aligned
33,study7Line,14.0,6,28,2646,29,stackbar,set4,-1,1,False,0.16992500144231237,4,3,non-aligned,non-aligned
33,study7Line,11.0,7,30,2647,33,stackbar,set4,-3,3,False,1.6438561897747246,8,0,start0,aligned
33,study7Line,10.0,8,33,2648,37,stackbar,set3,-4,4,False,2.0443941193584534,12,0,start0,aligned
33,study7Line,8.0,9,47,2649,47,stackbar,set1,0,0,True,-3.0,3,0,start0,aligned
33,study7Line,7.0,10,49,2650,49,stackbar,set2,0,0,True,-3.0,1,0,start0,aligned
33,study7Line,13.0,11,28,2651,27,stackbar,set1,1,1,False,0.16992500144231237,2,2,non-aligned,non-aligned
33,study7Line,16.0,12,15,2652,17,stackbar,set4,-2,2,False,1.0874628412503393,8,1,non-aligned,non-aligned
33,study7Line,12.0,13,18,2653,21,stackbar,set1,-3,3,False,1.6438561897747246,4,0,start0,aligned
33,study7Line,9.0,14,30,2654,32,stackbar,set3,-2,2,False,1.0874628412503393,7,2,non-aligned,non-aligned
33,study7Line,13.0,15,40,2655,45,stackbar,set3,-5,5,False,2.357552004618084,5,7,non-aligned,non-aligned
33,study7Line,10.0,16,20,2656,22,stackbar,set2,-2,2,False,1.0874628412503393,3,9,non-aligned,non-aligned
33,study7Line,16.0,17,40,2657,47,stackbar,set4,-7,7,False,2.8328900141647417,3,10,non-aligned,non-aligned
33,study7Line,12.0,18,30,2658,36,stackbar,set4,-6,6,False,2.6147098441152083,11,3,non-aligned,non-aligned
33,study7Line,15.0,19,43,2659,43,stackbar,set3,0,0,True,-3.0,7,3,non-aligned,non-aligned
33,study7Line,6.0,20,20,2660,21,stackbar,set4,-1,1,False,0.16992500144231237,4,2,non-aligned,non-aligned
33,study7Line,8.0,21,32,2661,32,stackbar,set1,0,0,True,-3.0,7,0,start0,aligned
33,study7Line,11.0,22,18,2662,18,stackbar,set2,0,0,True,-3.0,7,0,start0,aligned
33,study7Line,16.0,23,15,2663,16,stackbar,set4,-1,1,False,0.16992500144231237,9,3,non-aligned,non-aligned
33,study7Line,10.0,24,45,2664,44,stackbar,set4,1,1,False,0.16992500144231237,6,2,non-aligned,non-aligned
33,study7Line,7.0,25,20,2665,20,stackbar,set3,0,0,True,-3.0,5,0,start0,aligned
33,study7Line,6.0,26,50,2666,50,stackbar,set3,0,0,True,-3.0,0,0,start0,aligned
33,study7Line,15.0,27,32,2667,35,stackbar,set4,-3,3,False,1.6438561897747246,10,0,start0,aligned
33,study7Line,9.0,28,25,2668,25,stackbar,set1,0,0,True,-3.0,0,7,non-aligned,non-aligned
33,study7Line,10.0,29,32,2669,34,stackbar,set2,-2,2,False,1.0874628412503393,9,0,start0,aligned
33,study7Line,8.0,30,28,2670,28,stackbar,set4,0,0,True,-3.0,3,5,non-aligned,non-aligned
33,study7Line,8.0,31,30,2671,33,stackbar,set4,-3,3,False,1.6438561897747246,8,4,non-aligned,non-aligned
33,study7Line,7.0,32,12,2672,14,stackbar,set1,-2,2,False,1.0874628412503393,11,0,start0,aligned
33,study7Line,9.0,33,23,2673,23,stackbar,set2,0,0,True,-3.0,2,5,non-aligned,non-aligned
33,study7Line,9.0,34,25,2674,24,stackbar,set3,1,1,False,0.16992500144231237,1,8,non-aligned,non-aligned
33,study7Line,8.0,35,46,2675,44,stackbar,set4,2,2,False,1.0874628412503393,6,0,start0,aligned
33,study7Line,9.0,36,11,2676,13,stackbar,set2,-2,2,False,1.0874628412503393,12,6,non-aligned,non-aligned
33,study7Line,14.0,37,38,2677,41,stackbar,set4,-3,3,False,1.6438561897747246,9,4,non-aligned,non-aligned
33,study7Line,9.0,38,40,2678,40,stackbar,set1,0,0,True,-3.0,10,0,start0,aligned
33,study7Line,9.0,39,21,2679,20,stackbar,set4,1,1,False,0.16992500144231237,5,5,non-aligned,non-aligned
33,study7Line,15.0,40,47,2680,49,stackbar,set1,-2,2,False,1.0874628412503393,1,8,non-aligned,non-aligned
33,study7Line,13.0,41,46,2681,46,stackbar,set4,0,0,True,-3.0,4,2,non-aligned,non-aligned
33,study7Line,7.0,42,27,2682,28,stackbar,set1,-1,1,False,0.16992500144231237,3,0,start0,aligned
33,study7Line,8.0,43,17,2683,16,stackbar,set1,1,1,False,0.16992500144231237,9,0,start0,aligned
33,study7Line,9.0,44,27,2684,26,stackbar,set3,1,1,False,0.16992500144231237,1,3,non-aligned,non-aligned
33,study7Line,9.0,45,10,2685,12,stackbar,set3,-2,2,False,1.0874628412503393,12,0,start0,aligned
33,study7Line,7.0,46,50,2686,50,stackbar,set3,0,0,True,-3.0,0,5,non-aligned,non-aligned
33,study7Line,12.0,47,85,2687,40,stackbar,set4,45,45,False,5.495855026887171,10,2,non-aligned,non-aligned
33,study7Line,7.0,48,48,2688,48,stackbar,set1,0,0,True,-3.0,2,0,start0,aligned
33,study7Line,5.0,49,25,2689,25,stackbar,set4,0,0,True,-3.0,0,0,start0,aligned
33,study7Line,14.0,50,33,2690,37,stackbar,set2,-4,4,False,2.0443941193584534,12,5,non-aligned,non-aligned
33,study7Line,11.0,51,45,2691,48,stackbar,set3,-3,3,False,1.6438561897747246,2,2,non-aligned,non-aligned
33,study7Line,9.0,52,35,2692,39,stackbar,set3,-4,4,False,2.0443941193584534,11,3,non-aligned,non-aligned
33,study7Line,11.0,53,17,2693,18,stackbar,set1,-1,1,False,0.16992500144231237,7,1,non-aligned,non-aligned
33,study7Line,7.0,54,26,2694,26,stackbar,set2,0,0,True,-3.0,1,0,start0,aligned
33,study7Line,12.0,55,33,2695,38,stackbar,set4,-5,5,False,2.357552004618084,12,0,start0,aligned
33,study7Line,11.0,56,38,2696,34,stackbar,set2,4,4,False,2.0443941193584534,9,2,non-aligned,non-aligned
33,study7Line,7.0,57,46,2697,45,stackbar,set1,1,1,False,0.16992500144231237,5,0,start0,aligned
33,study7Line,8.0,58,42,2698,43,stackbar,set3,-1,1,False,0.16992500144231237,7,0,start0,aligned
33,study7Line,6.0,59,24,2699,24,stackbar,set3,0,0,True,-3.0,1,0,start0,aligned
33,study7Line,10.0,60,13,2700,15,stackbar,set4,-2,2,False,1.0874628412503393,10,0,start0,aligned
33,study7Line,9.0,61,46,2701,46,stackbar,set2,0,0,True,-3.0,4,0,start0,aligned
33,study7Line,6.0,62,27,2702,27,stackbar,set1,0,0,True,-3.0,2,0,start0,aligned
33,study7Line,6.0,63,23,2703,22,stackbar,set3,1,1,False,0.16992500144231237,3,0,start0,aligned
33,study7Line,6.0,64,10,2704,11,stackbar,set1,-1,1,False,0.16992500144231237,11,0,start0,aligned
33,study7Line,10.0,65,39,2705,42,stackbar,set1,-3,3,False,1.6438561897747246,8,3,non-aligned,non-aligned
33,study7Line,9.0,66,36,2706,36,stackbar,set4,0,0,True,-3.0,11,0,start0,aligned
33,study7Line,10.0,67,40,2707,42,stackbar,set3,-2,2,False,1.0874628412503393,8,0,start0,aligned
33,study7Line,9.0,68,8,2708,12,stackbar,set3,-4,4,False,2.0443941193584534,12,1,non-aligned,non-aligned
33,study7Line,7.0,69,28,2709,30,stackbar,set4,-2,2,False,1.0874628412503393,5,1,non-aligned,non-aligned
33,study7Line,8.0,70,15,2710,15,stackbar,set4,0,0,True,-3.0,10,4,non-aligned,non-aligned
33,study7Line,7.0,71,20,2711,19,stackbar,set4,1,1,False,0.16992500144231237,6,0,start0,aligned
33,study7Line,7.0,72,23,2712,23,stackbar,set4,0,0,True,-3.0,2,0,start0,aligned
33,study7Line,7.0,73,19,2713,17,stackbar,set3,2,2,False,1.0874628412503393,8,0,start0,aligned
33,study7Line,7.0,74,30,2714,31,stackbar,set2,-1,1,False,0.16992500144231237,6,0,start0,aligned
33,study7Line,11.0,75,38,2715,38,stackbar,set3,0,0,True,-3.0,12,3,non-aligned,non-aligned
33,study7Line,8.0,76,27,2716,29,stackbar,set1,-2,2,False,1.0874628412503393,4,0,start0,aligned
33,study7Line,10.0,77,35,2717,39,stackbar,set1,-4,4,False,2.0443941193584534,11,0,start0,aligned
33,study7Line,7.0,78,7,2718,11,stackbar,set1,-4,4,False,2.0443941193584534,11,4,non-aligned,non-aligned
33,study7Line,13.0,79,32,2719,35,stackbar,set2,-3,3,False,1.6438561897747246,10,3,non-aligned,non-aligned
9,study7Line,25.0,0,40,720,44,stackbar,set3,-4,4,False,2.0443941193584534,6,8,non-aligned,non-aligned
9,study7Line,10.0,1,15,721,17,stackbar,set2,-2,2,False,1.0874628412503393,8,0,start0,aligned
9,study7Line,11.0,2,50,722,45,stackbar,set1,5,5,False,2.357552004618084,5,2,non-aligned,non-aligned
9,study7Line,10.0,3,24,723,24,stackbar,set2,0,0,True,-3.0,1,0,start0,aligned
9,study7Line,7.0,4,20,724,21,stackbar,set1,-1,1,False,0.16992500144231237,4,0,start0,aligned
9,study7Line,18.0,5,15,725,15,stackbar,set4,0,0,True,-3.0,10,4,non-aligned,non-aligned
9,study7Line,15.0,6,50,726,47,stackbar,set3,3,3,False,1.6438561897747246,3,10,non-aligned,non-aligned
9,study7Line,8.0,7,20,727,20,stackbar,set1,0,0,True,-3.0,5,0,start75,aligned
9,study7Line,8.0,8,10,728,13,stackbar,set2,-3,3,False,1.6438561897747246,12,6,non-aligned,non-aligned
9,study7Line,8.0,9,10,729,12,stackbar,set3,-2,2,False,1.0874628412503393,12,0,start0,aligned
9,study7Line,11.0,10,30,730,30,stackbar,set4,0,0,True,-3.0,5,0,start0,aligned
9,study7Line,8.0,11,45,731,44,stackbar,set2,1,1,False,0.16992500144231237,6,0,start0,aligned
9,study7Line,10.0,12,50,732,49,stackbar,set1,1,1,False,0.16992500144231237,1,8,non-aligned,non-aligned
9,study7Line,9.0,13,40,733,38,stackbar,set1,2,2,False,1.0874628412503393,12,1,non-aligned,non-aligned
9,study7Line,10.0,14,40,734,35,stackbar,set1,5,5,False,2.357552004618084,10,6,non-aligned,non-aligned
9,study7Line,7.0,15,27,735,27,stackbar,set3,0,0,True,-3.0,2,0,start0,aligned
9,study7Line,6.0,16,30,736,29,stackbar,set2,1,1,False,0.16992500144231237,4,2,non-aligned,non-aligned
9,study7Line,9.0,17,50,737,43,stackbar,set2,7,7,False,2.8328900141647417,7,2,non-aligned,non-aligned
9,study7Line,6.0,18,50,738,46,stackbar,set2,4,4,False,2.0443941193584534,4,9,non-aligned,non-aligned
9,study7Line,15.0,19,20,739,19,stackbar,set3,1,1,False,0.16992500144231237,6,0,start0,aligned
9,study7Line,10.0,20,35,740,36,stackbar,set4,-1,1,False,0.16992500144231237,11,3,non-aligned,non-aligned
9,study7Line,6.0,21,25,741,28,stackbar,set1,-3,3,False,1.6438561897747246,3,10,non-aligned,non-aligned
9,study7Line,8.0,22,50,742,42,stackbar,set2,8,8,False,3.0223678130284544,8,4,non-aligned,non-aligned
9,study7Line,7.0,23,25,743,24,stackbar,set1,1,1,False,0.16992500144231237,1,5,non-aligned,non-aligned
9,study7Line,9.0,24,40,744,40,stackbar,set2,0,0,True,-3.0,10,0,start0,aligned
9,study7Line,5.0,25,40,745,36,stackbar,set1,4,4,False,2.0443941193584534,11,0,start0,aligned
9,study7Line,4.0,26,25,746,22,stackbar,set1,3,3,False,1.6438561897747246,3,2,non-aligned,non-aligned
9,study7Line,13.0,27,45,747,39,stackbar,set1,6,6,False,2.6147098441152083,11,4,non-aligned,non-aligned
9,study7Line,6.0,28,35,748,30,stackbar,set4,5,5,False,2.357552004618084,5,1,non-aligned,non-aligned
9,study7Line,6.0,29,25,749,25,stackbar,set2,0,0,True,-3.0,0,0,start0,aligned
9,study7Line,8.0,30,35,750,35,stackbar,set2,0,0,True,-3.0,10,0,start0,aligned
9,study7Line,5.0,31,45,751,45,stackbar,set3,0,0,True,-3.0,5,0,start0,aligned
9,study7Line,6.0,32,50,752,50,stackbar,set2,0,0,True,-3.0,0,0,start0,aligned
9,study7Line,6.0,33,47,753,48,stackbar,set2,-1,1,False,0.16992500144231237,2,0,start0,aligned
9,study7Line,7.0,34,40,754,42,stackbar,set4,-2,2,False,1.0874628412503393,8,0,start0,aligned
9,study7Line,6.0,35,25,755,27,stackbar,set2,-2,2,False,1.0874628412503393,2,11,non-aligned,non-aligned
9,study7Line,9.0,36,10,756,14,stackbar,set1,-4,4,False,2.0443941193584534,11,5,non-aligned,non-aligned
9,study7Line,5.0,37,30,757,29,stackbar,set1,1,1,False,0.16992500144231237,4,0,start0,aligned
9,study7Line,5.0,38,25,758,25,stackbar,set2,0,0,True,-3.0,0,8,non-aligned,non-aligned
9,study7Line,6.0,39,15,759,18,stackbar,set1,-3,3,False,1.6438561897747246,7,0,start0,aligned
9,study7Line,53.0,40,40,760,43,stackbar,set2,-3,3,False,1.6438561897747246,7,0,start0,aligned
9,study7Line,6.0,41,35,761,37,stackbar,set3,-2,2,False,1.0874628412503393,12,0,start25,aligned
9,study7Line,5.0,42,15,762,16,stackbar,set4,-1,1,False,0.16992500144231237,9,0,start0,aligned
9,study7Line,5.0,43,35,763,34,stackbar,set3,1,1,False,0.16992500144231237,9,3,non-aligned,non-aligned
9,study7Line,5.0,44,35,764,34,stackbar,set1,1,1,False,0.16992500144231237,9,0,start0,aligned
9,study7Line,7.0,45,13,765,15,stackbar,set1,-2,2,False,1.0874628412503393,10,0,start0,aligned
9,study7Line,7.0,46,48,766,49,stackbar,set2,-1,1,False,0.16992500144231237,1,0,start0,aligned
9,study7Line,5.0,47,22,767,23,stackbar,set2,-1,1,False,0.16992500144231237,2,0,start0,aligned
9,study7Line,8.0,48,20,768,19,stackbar,set4,1,1,False,0.16992500144231237,6,0,end75,aligned
9,study7Line,5.0,49,25,769,26,stackbar,set2,-1,1,False,0.16992500144231237,1,10,non-aligned,non-aligned
9,study7Line,5.0,50,30,770,33,stackbar,set3,-3,3,False,1.6438561897747246,8,3,non-aligned,non-aligned
9,study7Line,5.0,51,10,771,11,stackbar,set4,-1,1,False,0.16992500144231237,11,0,start0,aligned
9,study7Line,7.0,52,15,772,16,stackbar,set2,-1,1,False,0.16992500144231237,9,2,non-aligned,non-aligned
9,study7Line,5.0,53,30,773,31,stackbar,set3,-1,1,False,0.16992500144231237,6,2,non-aligned,non-aligned
9,study7Line,5.0,54,35,774,39,stackbar,set3,-4,4,False,2.0443941193584534,11,0,start0,aligned
9,study7Line,6.0,55,47,775,47,stackbar,set2,0,0,True,-3.0,3,0,start0,aligned
9,study7Line,6.0,56,28,776,28,stackbar,set2,0,0,True,-3.0,3,0,start0,aligned
9,study7Line,8.0,57,60,777,50,stackbar,set3,10,10,False,3.3398500028846247,0,5,non-aligned,non-aligned
9,study7Line,5.0,58,12,778,13,stackbar,set4,-1,1,False,0.16992500144231237,12,0,start0,aligned
9,study7Line,6.0,59,50,779,48,stackbar,set2,2,2,False,1.0874628412503393,2,2,non-aligned,non-aligned
9,study7Line,6.0,60,10,780,11,stackbar,set4,-1,1,False,0.16992500144231237,11,4,non-aligned,non-aligned
9,study7Line,6.0,61,40,781,40,stackbar,set4,0,0,True,-3.0,10,2,non-aligned,non-aligned
9,study7Line,10.0,62,12,782,14,stackbar,set4,-2,2,False,1.0874628412503393,11,0,start0,aligned
9,study7Line,7.0,63,22,783,22,stackbar,set4,0,0,True,-3.0,3,0,start0,aligned
9,study7Line,6.0,64,10,784,12,stackbar,set3,-2,2,False,1.0874628412503393,12,1,non-aligned,non-aligned
9,study7Line,7.0,65,20,785,23,stackbar,set3,-3,3,False,1.6438561897747246,2,10,non-aligned,non-aligned
9,study7Line,4.0,66,30,786,33,stackbar,set2,-3,3,False,1.6438561897747246,8,0,start0,aligned
9,study7Line,4.0,67,30,787,31,stackbar,set2,-1,1,False,0.16992500144231237,6,0,start0,aligned
9,study7Line,5.0,68,22,788,20,stackbar,set3,2,2,False,1.0874628412503393,5,0,start0,aligned
9,study7Line,8.0,69,30,789,32,stackbar,set4,-2,2,False,1.0874628412503393,7,7,non-aligned,non-aligned
9,study7Line,5.0,70,42,790,41,stackbar,set3,1,1,False,0.16992500144231237,9,0,start0,aligned
9,study7Line,5.0,71,26,791,26,stackbar,set3,0,0,True,-3.0,1,0,start0,aligned
9,study7Line,6.0,72,35,792,37,stackbar,set1,-2,2,False,1.0874628412503393,12,0,start0,aligned
9,study7Line,5.0,73,15,793,17,stackbar,set3,-2,2,False,1.0874628412503393,8,3,non-aligned,non-aligned
9,study7Line,13.0,74,20,794,21,stackbar,set2,-1,1,False,0.16992500144231237,4,6,non-aligned,non-aligned
9,study7Line,6.0,75,15,795,18,stackbar,set1,-3,3,False,1.6438561897747246,7,1,non-aligned,non-aligned
9,study7Line,5.0,76,47,796,46,stackbar,set1,1,1,False,0.16992500144231237,4,0,start0,aligned
9,study7Line,5.0,77,50,797,41,stackbar,set4,9,9,False,3.189824558880017,9,4,non-aligned,non-aligned
9,study7Line,8.0,78,30,798,32,stackbar,set1,-2,2,False,1.0874628412503393,7,0,start0,aligned
9,study7Line,7.0,79,40,799,38,stackbar,set3,2,2,False,1.0874628412503393,12,0,start0,aligned
14,study7Line,9.0,0,18,1120,19,stackbar,set3,-1,1,False,0.16992500144231237,6,0,start0,aligned
14,study7Line,6.0,1,30,1121,31,stackbar,set3,-1,1,False,0.16992500144231237,6,0,start0,aligned
14,study7Line,12.0,2,27,1122,28,stackbar,set4,-1,1,False,0.16992500144231237,3,0,start0,aligned
14,study7Line,7.0,3,33,1123,34,stackbar,set4,-1,1,False,0.16992500144231237,9,0,start0,aligned
14,study7Line,12.0,4,18,1124,19,stackbar,set1,-1,1,False,0.16992500144231237,6,8,non-aligned,non-aligned
14,study7Line,5.0,5,12,1125,14,stackbar,set3,-2,2,False,1.0874628412503393,11,0,start0,aligned
14,study7Line,6.0,6,17,1126,16,stackbar,set1,1,1,False,0.16992500144231237,9,0,start0,aligned
14,study7Line,5.0,7,29,1127,32,stackbar,set3,-3,3,False,1.6438561897747246,7,2,non-aligned,non-aligned
14,study7Line,6.0,8,45,1128,43,stackbar,set1,2,2,False,1.0874628412503393,7,2,non-aligned,non-aligned
14,study7Line,6.0,9,50,1129,50,stackbar,set4,0,0,True,-3.0,0,7,non-aligned,non-aligned
14,study7Line,5.0,10,25,1130,25,stackbar,set2,0,0,True,-3.0,0,0,start0,aligned
14,study7Line,9.0,11,25,1131,28,stackbar,set4,-3,3,False,1.6438561897747246,3,5,non-aligned,non-aligned
14,study7Line,6.0,12,10,1132,13,stackbar,set3,-3,3,False,1.6438561897747246,12,0,start0,aligned
14,study7Line,5.0,13,16,1133,17,stackbar,set3,-1,1,False,0.16992500144231237,8,0,start0,aligned
14,study7Line,7.0,14,11,1134,11,stackbar,set3,0,0,True,-3.0,11,5,non-aligned,non-aligned
14,study7Line,5.0,15,45,1135,43,stackbar,set2,2,2,False,1.0874628412503393,7,0,start0,aligned
14,study7Line,10.0,16,25,1136,27,stackbar,set2,-2,2,False,1.0874628412503393,2,11,non-aligned,non-aligned
14,study7Line,6.0,17,24,1137,23,stackbar,set3,1,1,False,0.16992500144231237,2,0,start0,aligned
14,study7Line,6.0,18,25,1138,29,stackbar,set3,-4,4,False,2.0443941193584534,4,9,non-aligned,non-aligned
14,study7Line,8.0,19,35,1139,37,stackbar,set2,-2,2,False,1.0874628412503393,12,0,start0,aligned
14,study7Line,5.0,20,13,1140,15,stackbar,set2,-2,2,False,1.0874628412503393,10,0,start0,aligned
14,study7Line,10.0,21,15,1141,15,stackbar,set1,0,0,True,-3.0,10,5,non-aligned,non-aligned
14,study7Line,6.0,22,26,1142,23,stackbar,set2,3,3,False,1.6438561897747246,2,5,non-aligned,non-aligned
14,study7Line,6.0,23,42,1143,42,stackbar,set4,0,0,True,-3.0,8,0,start0,aligned
14,study7Line,12.0,24,40,1144,41,stackbar,set4,-1,1,False,0.16992500144231237,9,4,non-aligned,non-aligned
14,study7Line,10.0,25,17,1145,17,stackbar,set3,0,0,True,-3.0,8,3,non-aligned,non-aligned
14,study7Line,5.0,26,25,1146,25,stackbar,set4,0,0,True,-3.0,0,0,start25,aligned
14,study7Line,4.0,27,22,1147,21,stackbar,set3,1,1,False,0.16992500144231237,4,0,start0,aligned
14,study7Line,5.0,28,30,1148,30,stackbar,set1,0,0,True,-3.0,5,0,start0,aligned
14,study7Line,10.0,29,13,1149,14,stackbar,set4,-1,1,False,0.16992500144231237,11,6,non-aligned,non-aligned
14,study7Line,6.0,30,35,1150,36,stackbar,set4,-1,1,False,0.16992500144231237,11,0,start0,aligned
14,study7Line,6.0,31,18,1151,18,stackbar,set2,0,0,True,-3.0,7,0,start0,aligned
14,study7Line,16.0,32,43,1152,38,stackbar,set4,5,5,False,2.357552004618084,12,6,non-aligned,non-aligned
14,study7Line,17.0,33,33,1153,30,stackbar,set1,3,3,False,1.6438561897747246,5,8,non-aligned,non-aligned
14,study7Line,5.0,34,35,1154,38,stackbar,set1,-3,3,False,1.6438561897747246,12,0,start0,aligned
14,study7Line,7.0,35,46,1155,47,stackbar,set2,-1,1,False,0.16992500144231237,3,2,non-aligned,non-aligned
14,study7Line,5.0,36,50,1156,50,stackbar,set1,0,0,True,-3.0,0,0,start0,aligned
14,study7Line,5.0,37,10,1157,11,stackbar,set1,-1,1,False,0.16992500144231237,11,0,start0,aligned
14,study7Line,10.0,38,37,1158,39,stackbar,set2,-2,2,False,1.0874628412503393,11,1,non-aligned,non-aligned
14,study7Line,6.0,39,25,1159,26,stackbar,set1,-1,1,False,0.16992500144231237,1,3,non-aligned,non-aligned
14,study7Line,3.0,40,26,1160,26,stackbar,set4,0,0,True,-3.0,1,0,start0,aligned
14,study7Line,7.0,41,24,1161,24,stackbar,set2,0,0,True,-3.0,1,0,start0,aligned
14,study7Line,4.0,42,48,1162,48,stackbar,set2,0,0,True,-3.0,2,0,start0,aligned
14,study7Line,5.0,43,20,1163,20,stackbar,set1,0,0,True,-3.0,5,0,start0,aligned
14,study7Line,7.0,44,37,1164,39,stackbar,set3,-2,2,False,1.0874628412503393,11,0,start0,aligned
14,study7Line,26.0,45,45,1165,45,stackbar,set2,0,0,True,-3.0,5,9,non-aligned,non-aligned
14,study7Line,10.0,46,15,1166,16,stackbar,set1,-1,1,False,0.16992500144231237,9,1,non-aligned,non-aligned
14,study7Line,8.0,47,20,1167,22,stackbar,set2,-2,2,False,1.0874628412503393,3,9,non-aligned,non-aligned
14,study7Line,14.0,48,37,1168,33,stackbar,set4,4,4,False,2.0443941193584534,8,4,non-aligned,non-aligned
14,study7Line,5.0,49,24,1169,24,stackbar,set2,0,0,True,-3.0,1,2,non-aligned,non-aligned
14,study7Line,6.0,50,11,1170,12,stackbar,set1,-1,1,False,0.16992500144231237,12,0,start0,aligned
14,study7Line,6.0,51,49,1171,49,stackbar,set4,0,0,True,-3.0,1,0,start0,aligned
14,study7Line,6.0,52,30,1172,32,stackbar,set2,-2,2,False,1.0874628412503393,7,0,start0,aligned
14,study7Line,8.0,53,17,1173,18,stackbar,set1,-1,1,False,0.16992500144231237,7,1,non-aligned,non-aligned
14,study7Line,5.0,54,23,1174,22,stackbar,set4,1,1,False,0.16992500144231237,3,0,start0,aligned
14,study7Line,7.0,55,37,1175,37,stackbar,set3,0,0,True,-3.0,12,0,start25,aligned
14,study7Line,9.0,56,11,1176,13,stackbar,set4,-2,2,False,1.0874628412503393,12,6,non-aligned,non-aligned
14,study7Line,7.0,57,50,1177,49,stackbar,set4,1,1,False,0.16992500144231237,1,5,non-aligned,non-aligned
14,study7Line,10.0,58,33,1178,35,stackbar,set2,-2,2,False,1.0874628412503393,10,3,non-aligned,non-aligned
14,study7Line,4.0,59,35,1179,35,stackbar,set1,0,0,True,-3.0,10,0,start0,aligned
14,study7Line,5.0,60,20,1180,20,stackbar,set3,0,0,True,-3.0,5,2,non-aligned,non-aligned
14,study7Line,11.0,61,36,1181,44,stackbar,set1,-8,8,False,3.0223678130284544,6,2,non-aligned,non-aligned
14,study7Line,4.0,62,26,1182,27,stackbar,set1,-1,1,False,0.16992500144231237,2,0,start0,aligned
14,study7Line,5.0,63,47,1183,47,stackbar,set3,0,0,True,-3.0,3,0,start0,aligned
14,study7Line,7.0,64,22,1184,21,stackbar,set2,1,1,False,0.16992500144231237,4,6,non-aligned,non-aligned
14,study7Line,8.0,65,12,1185,12,stackbar,set1,0,0,True,-3.0,12,1,non-aligned,non-aligned
14,study7Line,7.0,66,33,1186,36,stackbar,set4,-3,3,False,1.6438561897747246,11,3,non-aligned,non-aligned
14,study7Line,7.0,67,40,1187,44,stackbar,set2,-4,4,False,2.0443941193584534,6,0,start0,aligned
14,study7Line,6.0,68,37,1188,40,stackbar,set1,-3,3,False,1.6438561897747246,10,0,start0,aligned
14,study7Line,7.0,69,35,1189,34,stackbar,set2,1,1,False,0.16992500144231237,9,2,non-aligned,non-aligned
14,study7Line,6.0,70,30,1190,33,stackbar,set2,-3,3,False,1.6438561897747246,8,0,start0,aligned
14,study7Line,6.0,71,45,1191,46,stackbar,set2,-1,1,False,0.16992500144231237,4,9,non-aligned,non-aligned
14,study7Line,9.0,72,54,1192,48,stackbar,set1,6,6,False,2.6147098441152083,2,9,non-aligned,non-aligned
14,study7Line,6.0,73,43,1193,45,stackbar,set2,-2,2,False,1.0874628412503393,5,0,start0,aligned
14,study7Line,4.0,74,27,1194,29,stackbar,set1,-2,2,False,1.0874628412503393,4,0,start0,aligned
14,study7Line,6.0,75,38,1195,41,stackbar,set2,-3,3,False,1.6438561897747246,9,0,start0,aligned
14,study7Line,15.0,76,35,1196,40,stackbar,set4,-5,5,False,2.357552004618084,10,2,non-aligned,non-aligned
14,study7Line,5.0,77,48,1197,46,stackbar,set4,2,2,False,1.0874628412503393,4,0,start0,aligned
14,study7Line,7.0,78,45,1198,42,stackbar,set3,3,3,False,1.6438561897747246,8,7,non-aligned,non-aligned
14,study7Line,4.0,79,30,1199,31,stackbar,set3,-1,1,False,0.16992500144231237,6,2,non-aligned,non-aligned
26,study7Line,29.0,0,21,2080,22,stackbar,set4,-1,1,False,0.16992500144231237,3,0,start0,aligned
26,study7Line,11.0,1,26,2081,26,stackbar,set3,0,0,True,-3.0,1,0,start0,aligned
26,study7Line,8.0,2,27,2082,27,stackbar,set4,0,0,True,-3.0,2,0,start0,aligned
26,study7Line,13.0,3,45,2083,47,stackbar,set3,-2,2,False,1.0874628412503393,3,0,start0,aligned
26,study7Line,69.0,4,35,2084,33,stackbar,set4,2,2,False,1.0874628412503393,8,4,non-aligned,non-aligned
26,study7Line,14.0,5,48,2085,49,stackbar,set1,-1,1,False,0.16992500144231237,1,0,start0,aligned
26,study7Line,13.0,6,30,2086,35,stackbar,set4,-5,5,False,2.357552004618084,10,0,end100,aligned
26,study7Line,10.0,7,45,2087,46,stackbar,set2,-1,1,False,0.16992500144231237,4,0,start0,aligned
26,study7Line,21.0,8,30,2088,34,stackbar,set2,-4,4,False,2.0443941193584534,9,2,non-aligned,non-aligned
26,study7Line,14.0,9,15,2089,13,stackbar,set4,2,2,False,1.0874628412503393,12,6,non-aligned,non-aligned
26,study7Line,11.0,10,50,2090,47,stackbar,set4,3,3,False,1.6438561897747246,3,10,non-aligned,non-aligned
26,study7Line,12.0,11,30,2091,29,stackbar,set1,1,1,False,0.16992500144231237,4,2,non-aligned,non-aligned
26,study7Line,28.0,12,43,2092,45,stackbar,set1,-2,2,False,1.0874628412503393,5,2,non-aligned,non-aligned
26,study7Line,13.0,13,23,2093,23,stackbar,set4,0,0,True,-3.0,2,0,start0,aligned
26,study7Line,11.0,14,32,2094,32,stackbar,set1,0,0,True,-3.0,7,0,start0,aligned
26,study7Line,14.0,15,48,2095,49,stackbar,set3,-1,1,False,0.16992500144231237,1,1,non-aligned,non-aligned
26,study7Line,7.0,16,24,2096,24,stackbar,set1,0,0,True,-3.0,1,0,start0,aligned
26,study7Line,9.0,17,13,2097,15,stackbar,set1,-2,2,False,1.0874628412503393,10,0,start0,aligned
26,study7Line,34.0,18,37,2098,37,stackbar,set4,0,0,True,-3.0,12,1,non-aligned,non-aligned
26,study7Line,8.0,19,30,2099,29,stackbar,set2,1,1,False,0.16992500144231237,4,0,start0,aligned
26,study7Line,64.0,20,40,2100,43,stackbar,set2,-3,3,False,1.6438561897747246,7,2,non-aligned,non-aligned
26,study7Line,27.0,21,42,2101,40,stackbar,set1,2,2,False,1.0874628412503393,10,6,non-aligned,non-aligned
26,study7Line,14.0,22,38,2102,40,stackbar,set4,-2,2,False,1.0874628412503393,10,0,start0,aligned
26,study7Line,38.0,23,42,2103,46,stackbar,set1,-4,4,False,2.0443941193584534,4,6,non-aligned,non-aligned
26,study7Line,8.0,24,32,2104,35,stackbar,set2,-3,3,False,1.6438561897747246,10,0,start0,aligned
26,study7Line,8.0,25,12,2105,13,stackbar,set3,-1,1,False,0.16992500144231237,12,0,start0,aligned
26,study7Line,43.0,26,37,2106,36,stackbar,set2,1,1,False,0.16992500144231237,11,1,non-aligned,non-aligned
26,study7Line,15.0,27,44,2107,45,stackbar,set2,-1,1,False,0.16992500144231237,5,0,start0,aligned
26,study7Line,13.0,28,49,2108,50,stackbar,set3,-1,1,False,0.16992500144231237,0,5,non-aligned,non-aligned
26,study7Line,15.0,29,20,2109,18,stackbar,set1,2,2,False,1.0874628412503393,7,1,non-aligned,non-aligned
26,study7Line,21.0,30,35,2110,38,stackbar,set1,-3,3,False,1.6438561897747246,12,0,start0,aligned
26,study7Line,25.0,31,40,2111,43,stackbar,set1,-3,3,False,1.6438561897747246,7,0,start0,aligned
26,study7Line,13.0,32,28,2112,27,stackbar,set1,1,1,False,0.16992500144231237,2,2,non-aligned,non-aligned
26,study7Line,61.0,33,35,2113,37,stackbar,set3,-2,2,False,1.0874628412503393,12,0,start0,aligned
26,study7Line,9.0,34,30,2114,30,stackbar,set4,0,0,True,-3.0,5,0,start0,aligned
26,study7Line,19.0,35,48,2115,48,stackbar,set3,0,0,True,-3.0,2,2,non-aligned,non-aligned
26,study7Line,19.0,36,30,2116,30,stackbar,set2,0,0,True,-3.0,5,4,non-aligned,non-aligned
26,study7Line,11.0,37,12,2117,15,stackbar,set3,-3,3,False,1.6438561897747246,10,3,non-aligned,non-aligned
26,study7Line,11.0,38,10,2118,12,stackbar,set2,-2,2,False,1.0874628412503393,12,0,start0,aligned
26,study7Line,9.0,39,34,2119,32,stackbar,set3,2,2,False,1.0874628412503393,7,2,non-aligned,non-aligned
26,study7Line,9.0,40,18,2120,17,stackbar,set4,1,1,False,0.16992500144231237,8,1,non-aligned,non-aligned
26,study7Line,7.0,41,31,2121,31,stackbar,set1,0,0,True,-3.0,6,0,start0,aligned
26,study7Line,9.0,42,39,2122,42,stackbar,set3,-3,3,False,1.6438561897747246,8,0,start0,aligned
26,study7Line,7.0,43,25,2123,25,stackbar,set1,0,0,True,-3.0,0,0,start0,aligned
26,study7Line,7.0,44,20,2124,20,stackbar,set3,0,0,True,-3.0,5,2,non-aligned,non-aligned
26,study7Line,6.0,45,25,2125,24,stackbar,set3,1,1,False,0.16992500144231237,1,8,non-aligned,non-aligned
26,study7Line,11.0,46,38,2126,41,stackbar,set2,-3,3,False,1.6438561897747246,9,0,start0,aligned
26,study7Line,4.0,47,12,2127,11,stackbar,set3,1,1,False,0.16992500144231237,11,0,start0,aligned
26,study7Line,6.0,48,14,2128,14,stackbar,set1,0,0,True,-3.0,11,0,start0,aligned
26,study7Line,6.0,49,13,2129,12,stackbar,set4,1,1,False,0.16992500144231237,12,6,non-aligned,non-aligned
26,study7Line,6.0,50,31,2130,33,stackbar,set4,-2,2,False,1.0874628412503393,8,0,start0,aligned
26,study7Line,11.0,51,30,2131,26,stackbar,set2,4,4,False,2.0443941193584534,1,10,non-aligned,non-aligned
26,study7Line,7.0,52,40,2132,44,stackbar,set2,-4,4,False,2.0443941193584534,6,9,non-aligned,non-aligned
26,study7Line,9.0,53,28,2133,28,stackbar,set1,0,0,True,-3.0,3,10,non-aligned,non-aligned
26,study7Line,26.0,54,28,2134,31,stackbar,set1,-3,3,False,1.6438561897747246,6,4,non-aligned,non-aligned
26,study7Line,6.0,55,40,2135,44,stackbar,set4,-4,4,False,2.0443941193584534,6,0,start0,aligned
26,study7Line,5.0,56,15,2136,18,stackbar,set1,-3,3,False,1.6438561897747246,7,0,start0,aligned
26,study7Line,4.0,57,20,2137,21,stackbar,set1,-1,1,False,0.16992500144231237,4,0,start0,aligned
26,study7Line,16.0,58,12,2138,11,stackbar,set2,1,1,False,0.16992500144231237,11,2,non-aligned,non-aligned
26,study7Line,6.0,59,12,2139,14,stackbar,set4,-2,2,False,1.0874628412503393,11,6,non-aligned,non-aligned
26,study7Line,6.0,60,29,2140,28,stackbar,set2,1,1,False,0.16992500144231237,3,0,start0,aligned
26,study7Line,12.0,61,15,2141,17,stackbar,set1,-2,2,False,1.0874628412503393,8,0,start0,aligned
26,study7Line,7.0,62,23,2142,22,stackbar,set3,1,1,False,0.16992500144231237,3,2,non-aligned,non-aligned
26,study7Line,18.0,63,15,2143,16,stackbar,set4,-1,1,False,0.16992500144231237,9,0,start0,aligned
26,study7Line,6.0,64,20,2144,20,stackbar,set1,0,0,True,-3.0,5,0,start0,aligned
26,study7Line,9.0,65,18,2145,16,stackbar,set1,2,2,False,1.0874628412503393,9,1,non-aligned,non-aligned
26,study7Line,8.0,66,47,2146,48,stackbar,set1,-1,1,False,0.16992500144231237,2,0,start0,aligned
26,study7Line,6.0,67,20,2147,21,stackbar,set3,-1,1,False,0.16992500144231237,4,2,non-aligned,non-aligned
26,study7Line,14.0,68,20,2148,19,stackbar,set4,1,1,False,0.16992500144231237,6,0,end75,aligned
26,study7Line,20.0,69,40,2149,39,stackbar,set3,1,1,False,0.16992500144231237,11,3,non-aligned,non-aligned
26,study7Line,9.0,70,34,2150,34,stackbar,set2,0,0,True,-3.0,9,0,start0,aligned
26,study7Line,10.0,71,45,2151,42,stackbar,set4,3,3,False,1.6438561897747246,8,1,non-aligned,non-aligned
26,study7Line,13.0,72,30,2152,38,stackbar,set2,-8,8,False,3.0223678130284544,12,5,non-aligned,non-aligned
26,study7Line,7.0,73,50,2153,50,stackbar,set2,0,0,True,-3.0,0,0,start0,aligned
26,study7Line,7.0,74,18,2154,19,stackbar,set4,-1,1,False,0.16992500144231237,6,0,start0,aligned
26,study7Line,7.0,75,25,2155,25,stackbar,set4,0,0,True,-3.0,0,0,start25,aligned
26,study7Line,8.0,76,24,2156,23,stackbar,set2,1,1,False,0.16992500144231237,2,5,non-aligned,non-aligned
26,study7Line,16.0,77,40,2157,41,stackbar,set2,-1,1,False,0.16992500144231237,9,4,non-aligned,non-aligned
26,study7Line,5.0,78,33,2158,36,stackbar,set2,-3,3,False,1.6438561897747246,11,0,start0,aligned
26,study7Line,7.0,79,38,2159,39,stackbar,set3,-1,1,False,0.16992500144231237,11,0,start0,aligned
11,study7Line,21.0,0,15,880,16,stackbar,set2,-1,1,False,0.16992500144231237,9,0,start0,aligned
11,study7Line,32.0,1,20,881,21,stackbar,set3,-1,1,False,0.16992500144231237,4,2,non-aligned,non-aligned
11,study7Line,29.0,2,38,882,35,stackbar,set3,3,3,False,1.6438561897747246,10,2,non-aligned,non-aligned
11,study7Line,25.0,3,40,883,42,stackbar,set1,-2,2,False,1.0874628412503393,8,0,start0,aligned
11,study7Line,16.0,4,25,884,25,stackbar,set2,0,0,True,-3.0,0,8,non-aligned,non-aligned
11,study7Line,19.0,5,12,885,18,stackbar,set3,-6,6,False,2.6147098441152083,7,2,non-aligned,non-aligned
11,study7Line,28.0,6,40,886,40,stackbar,set1,0,0,True,-3.0,10,0,start0,aligned
11,study7Line,29.0,7,15,887,17,stackbar,set4,-2,2,False,1.0874628412503393,8,1,non-aligned,non-aligned
11,study7Line,20.0,8,9,888,11,stackbar,set3,-2,2,False,1.0874628412503393,11,0,start0,aligned
11,study7Line,15.0,9,40,889,46,stackbar,set3,-6,6,False,2.6147098441152083,4,10,non-aligned,non-aligned
11,study7Line,12.0,10,20,890,20,stackbar,set3,0,0,True,-3.0,5,0,start0,aligned
11,study7Line,30.0,11,54,891,38,stackbar,set4,16,16,False,4.011227255423254,12,6,non-aligned,non-aligned
11,study7Line,19.0,12,45,892,47,stackbar,set2,-2,2,False,1.0874628412503393,3,2,non-aligned,non-aligned
11,study7Line,20.0,13,30,893,29,stackbar,set2,1,1,False,0.16992500144231237,4,2,non-aligned,non-aligned
11,study7Line,17.0,14,40,894,41,stackbar,set2,-1,1,False,0.16992500144231237,9,0,start0,aligned
11,study7Line,14.0,15,25,895,24,stackbar,set2,1,1,False,0.16992500144231237,1,2,non-aligned,non-aligned
11,study7Line,11.0,16,40,896,31,stackbar,set3,9,9,False,3.189824558880017,6,2,non-aligned,non-aligned
11,study7Line,29.0,17,30,897,32,stackbar,set2,-2,2,False,1.0874628412503393,7,6,non-aligned,non-aligned
11,study7Line,8.0,18,10,898,12,stackbar,set2,-2,2,False,1.0874628412503393,12,0,start0,aligned
11,study7Line,13.0,19,20,899,18,stackbar,set1,2,2,False,1.0874628412503393,7,0,start0,aligned
11,study7Line,557.0,20,30,900,32,stackbar,set2,-2,2,False,1.0874628412503393,7,0,start0,aligned
11,study7Line,11.0,21,20,901,22,stackbar,set4,-2,2,False,1.0874628412503393,3,0,start75,aligned
11,study7Line,117.0,22,15,902,15,stackbar,set2,0,0,True,-3.0,10,0,start0,aligned
11,study7Line,20.0,23,32,903,30,stackbar,set4,2,2,False,1.0874628412503393,5,0,start0,aligned
11,study7Line,42.0,24,10,904,11,stackbar,set4,-1,1,False,0.16992500144231237,11,4,non-aligned,non-aligned
11,study7Line,20.0,25,16,905,13,stackbar,set3,3,3,False,1.6438561897747246,12,2,non-aligned,non-aligned
11,study7Line,24.0,26,32,906,34,stackbar,set1,-2,2,False,1.0874628412503393,9,0,start0,aligned
11,study7Line,30.0,27,42,907,43,stackbar,set4,-1,1,False,0.16992500144231237,7,6,non-aligned,non-aligned
11,study7Line,28.0,28,42,908,41,stackbar,set2,1,1,False,0.16992500144231237,9,4,non-aligned,non-aligned
11,study7Line,16.0,29,14,909,17,stackbar,set1,-3,3,False,1.6438561897747246,8,0,start0,aligned
11,study7Line,36.0,30,37,910,37,stackbar,set3,0,0,True,-3.0,12,0,start25,aligned
11,study7Line,9.0,31,25,911,25,stackbar,set3,0,0,True,-3.0,0,0,start0,aligned
11,study7Line,33.0,32,31,912,36,stackbar,set1,-5,5,False,2.357552004618084,11,3,non-aligned,non-aligned
11,study7Line,11.0,33,13,913,12,stackbar,set3,1,1,False,0.16992500144231237,12,1,non-aligned,non-aligned
11,study7Line,23.0,34,27,914,27,stackbar,set2,0,0,True,-3.0,2,0,start0,aligned
11,study7Line,14.0,35,38,915,39,stackbar,set2,-1,1,False,0.16992500144231237,11,0,start0,aligned
11,study7Line,16.0,36,36,916,33,stackbar,set3,3,3,False,1.6438561897747246,8,3,non-aligned,non-aligned
11,study7Line,9.0,37,20,917,22,stackbar,set1,-2,2,False,1.0874628412503393,3,0,start0,aligned
11,study7Line,13.0,38,31,918,30,stackbar,set1,1,1,False,0.16992500144231237,5,8,non-aligned,non-aligned
11,study7Line,16.0,39,15,919,14,stackbar,set3,1,1,False,0.16992500144231237,11,2,non-aligned,non-aligned
11,study7Line,114.0,40,18,920,15,stackbar,set4,3,3,False,1.6438561897747246,10,4,non-aligned,non-aligned
11,study7Line,7.0,41,30,921,29,stackbar,set4,1,1,False,0.16992500144231237,4,0,start0,aligned
11,study7Line,18.0,42,32,922,28,stackbar,set2,4,4,False,2.0443941193584534,3,8,non-aligned,non-aligned
11,study7Line,17.0,43,32,923,31,stackbar,set3,1,1,False,0.16992500144231237,6,0,start0,aligned
11,study7Line,12.0,44,12,924,13,stackbar,set1,-1,1,False,0.16992500144231237,12,0,start0,aligned
11,study7Line,12.0,45,48,925,49,stackbar,set1,-1,1,False,0.16992500144231237,1,0,start0,aligned
11,study7Line,30.0,46,48,926,49,stackbar,set2,-1,1,False,0.16992500144231237,1,8,non-aligned,non-aligned
11,study7Line,36.0,47,20,927,23,stackbar,set2,-3,3,False,1.6438561897747246,2,5,non-aligned,non-aligned
11,study7Line,16.0,48,45,928,45,stackbar,set3,0,0,True,-3.0,5,7,non-aligned,non-aligned
11,study7Line,9.0,49,18,929,19,stackbar,set1,-1,1,False,0.16992500144231237,6,0,start0,aligned
11,study7Line,11.0,50,29,930,33,stackbar,set2,-4,4,False,2.0443941193584534,8,0,start0,aligned
11,study7Line,23.0,51,15,931,16,stackbar,set2,-1,1,False,0.16992500144231237,9,2,non-aligned,non-aligned
11,study7Line,25.0,52,34,932,43,stackbar,set3,-9,9,False,3.189824558880017,7,0,start0,aligned
11,study7Line,29.0,53,39,933,40,stackbar,set2,-1,1,False,0.16992500144231237,10,1,non-aligned,non-aligned
11,study7Line,11.0,54,41,934,45,stackbar,set3,-4,4,False,2.0443941193584534,5,0,start0,aligned
11,study7Line,13.0,55,50,935,50,stackbar,set1,0,0,True,-3.0,0,6,non-aligned,non-aligned
11,study7Line,14.0,56,50,936,26,stackbar,set2,24,24,False,4.592457037268081,1,10,non-aligned,non-aligned
11,study7Line,25.0,57,48,937,48,stackbar,set2,0,0,True,-3.0,2,2,non-aligned,non-aligned
11,study7Line,10.0,58,48,938,48,stackbar,set1,0,0,True,-3.0,2,0,start0,aligned
11,study7Line,75.0,59,29,939,35,stackbar,set4,-6,6,False,2.6147098441152083,10,0,start0,aligned
11,study7Line,13.0,60,40,940,44,stackbar,set4,-4,4,False,2.0443941193584534,6,0,start0,aligned
11,study7Line,32.0,61,29,941,36,stackbar,set1,-7,7,False,2.8328900141647417,11,0,start0,aligned
11,study7Line,20.0,62,47,942,47,stackbar,set1,0,0,True,-3.0,3,0,start0,aligned
11,study7Line,10.0,63,28,943,28,stackbar,set2,0,0,True,-3.0,3,0,start0,aligned
11,study7Line,16.0,64,65,944,42,stackbar,set2,23,23,False,4.531381460516312,8,4,non-aligned,non-aligned
11,study7Line,18.0,65,19,945,19,stackbar,set3,0,0,True,-3.0,6,1,non-aligned,non-aligned
11,study7Line,9.0,66,19,946,21,stackbar,set4,-2,2,False,1.0874628412503393,4,0,start0,aligned
11,study7Line,14.0,67,30,947,38,stackbar,set2,-8,8,False,3.0223678130284544,12,0,start0,aligned
11,study7Line,14.0,68,28,948,27,stackbar,set1,1,1,False,0.16992500144231237,2,2,non-aligned,non-aligned
11,study7Line,10.0,69,32,949,39,stackbar,set4,-7,7,False,2.8328900141647417,11,1,non-aligned,non-aligned
11,study7Line,9.0,70,45,950,46,stackbar,set2,-1,1,False,0.16992500144231237,4,0,start0,aligned
11,study7Line,7.0,71,26,951,26,stackbar,set4,0,0,True,-3.0,1,0,start0,aligned
11,study7Line,13.0,72,32,952,34,stackbar,set2,-2,2,False,1.0874628412503393,9,2,non-aligned,non-aligned
11,study7Line,7.0,73,24,953,24,stackbar,set3,0,0,True,-3.0,1,0,start0,aligned
11,study7Line,13.0,74,60,954,44,stackbar,set3,16,16,False,4.011227255423254,6,8,non-aligned,non-aligned
11,study7Line,9.0,75,23,955,23,stackbar,set4,0,0,True,-3.0,2,0,start0,aligned
11,study7Line,9.0,76,35,956,37,stackbar,set2,-2,2,False,1.0874628412503393,12,0,start0,aligned
11,study7Line,8.0,77,25,957,20,stackbar,set4,5,5,False,2.357552004618084,5,5,non-aligned,non-aligned
11,study7Line,8.0,78,13,958,14,stackbar,set1,-1,1,False,0.16992500144231237,11,0,start0,aligned
11,study7Line,5.0,79,50,959,50,stackbar,set1,0,0,True,-3.0,0,0,start0,aligned
23,study7Line,31.0,0,50,1840,50,stackbar,set3,0,0,True,-3.0,0,5,non-aligned,non-aligned
23,study7Line,22.0,1,27,1841,27,stackbar,set1,0,0,True,-3.0,2,0,start0,aligned
23,study7Line,18.0,2,23,1842,23,stackbar,set4,0,0,True,-3.0,2,0,start0,aligned
23,study7Line,38.0,3,42,1843,41,stackbar,set1,1,1,False,0.16992500144231237,9,0,start0,aligned
23,study7Line,20.0,4,15,1844,13,stackbar,set1,2,2,False,1.0874628412503393,12,6,non-aligned,non-aligned
23,study7Line,26.0,5,46,1845,45,stackbar,set4,1,1,False,0.16992500144231237,5,7,non-aligned,non-aligned
23,study7Line,31.0,6,35,1846,36,stackbar,set4,-1,1,False,0.16992500144231237,11,0,start0,aligned
23,study7Line,29.0,7,13,1847,11,stackbar,set3,2,2,False,1.0874628412503393,11,5,non-aligned,non-aligned
23,study7Line,25.0,8,36,1848,35,stackbar,set2,1,1,False,0.16992500144231237,10,3,non-aligned,non-aligned
23,study7Line,26.0,9,37,1849,33,stackbar,set4,4,4,False,2.0443941193584534,8,0,start0,aligned
23,study7Line,32.0,10,25,1850,25,stackbar,set1,0,0,True,-3.0,0,7,non-aligned,non-aligned
23,study7Line,10.0,11,22,1851,21,stackbar,set3,1,1,False,0.16992500144231237,4,2,non-aligned,non-aligned
23,study7Line,14.0,12,43,1852,44,stackbar,set1,-1,1,False,0.16992500144231237,6,0,start0,aligned
23,study7Line,21.0,13,30,1853,27,stackbar,set2,3,3,False,1.6438561897747246,2,11,non-aligned,non-aligned
23,study7Line,21.0,14,18,1854,19,stackbar,set4,-1,1,False,0.16992500144231237,6,0,end75,aligned
23,study7Line,22.0,15,35,1855,38,stackbar,set2,-3,3,False,1.6438561897747246,12,0,start0,aligned
23,study7Line,20.0,16,42,1856,39,stackbar,set2,3,3,False,1.6438561897747246,11,1,non-aligned,non-aligned
23,study7Line,15.0,17,30,1857,30,stackbar,set4,0,0,True,-3.0,5,0,start0,aligned
23,study7Line,20.0,18,35,1858,32,stackbar,set1,3,3,False,1.6438561897747246,7,2,non-aligned,non-aligned
23,study7Line,13.0,19,10,1859,12,stackbar,set4,-2,2,False,1.0874628412503393,12,0,start0,aligned
23,study7Line,8.0,20,20,1860,20,stackbar,set4,0,0,True,-3.0,5,0,start0,aligned
23,study7Line,8.0,21,23,1861,24,stackbar,set3,-1,1,False,0.16992500144231237,1,0,start0,aligned
23,study7Line,17.0,22,15,1862,15,stackbar,set2,0,0,True,-3.0,10,0,start0,aligned
23,study7Line,10.0,23,10,1863,11,stackbar,set2,-1,1,False,0.16992500144231237,11,0,start0,aligned
23,study7Line,13.0,24,25,1864,24,stackbar,set4,1,1,False,0.16992500144231237,1,9,non-aligned,non-aligned
23,study7Line,12.0,25,27,1865,26,stackbar,set4,1,1,False,0.16992500144231237,1,1,non-aligned,non-aligned
23,study7Line,10.0,26,15,1866,14,stackbar,set1,1,1,False,0.16992500144231237,11,5,non-aligned,non-aligned
23,study7Line,11.0,27,30,1867,28,stackbar,set4,2,2,False,1.0874628412503393,3,5,non-aligned,non-aligned
23,study7Line,21.0,28,35,1868,33,stackbar,set1,2,2,False,1.0874628412503393,8,6,non-aligned,non-aligned
23,study7Line,22.0,29,45,1869,37,stackbar,set3,8,8,False,3.0223678130284544,12,0,start25,aligned
23,study7Line,13.0,30,13,1870,14,stackbar,set3,-1,1,False,0.16992500144231237,11,0,start0,aligned
23,study7Line,19.0,31,43,1871,42,stackbar,set1,1,1,False,0.16992500144231237,8,0,start0,aligned
23,study7Line,14.0,32,32,1872,31,stackbar,set4,1,1,False,0.16992500144231237,6,0,end50,aligned
23,study7Line,21.0,33,35,1873,34,stackbar,set1,1,1,False,0.16992500144231237,9,6,non-aligned,non-aligned
23,study7Line,9.0,34,18,1874,18,stackbar,set1,0,0,True,-3.0,7,1,non-aligned,non-aligned
23,study7Line,12.0,35,50,1875,49,stackbar,set2,1,1,False,0.16992500144231237,1,8,non-aligned,non-aligned
23,study7Line,8.0,36,50,1876,42,stackbar,set3,8,8,False,3.0223678130284544,8,7,non-aligned,non-aligned
23,study7Line,11.0,37,37,1877,40,stackbar,set1,-3,3,False,1.6438561897747246,10,0,start0,aligned
23,study7Line,22.0,38,45,1878,45,stackbar,set4,0,0,True,-3.0,5,0,start0,aligned
23,study7Line,10.0,39,47,1879,48,stackbar,set2,-1,1,False,0.16992500144231237,2,0,start0,aligned
23,study7Line,13.0,40,14,1880,12,stackbar,set3,2,2,False,1.0874628412503393,12,1,non-aligned,non-aligned
23,study7Line,18.0,41,40,1881,38,stackbar,set4,2,2,False,1.0874628412503393,12,6,non-aligned,non-aligned
23,study7Line,14.0,42,14,1882,15,stackbar,set4,-1,1,False,0.16992500144231237,10,4,non-aligned,non-aligned
23,study7Line,12.0,43,15,1883,17,stackbar,set1,-2,2,False,1.0874628412503393,8,0,start0,aligned
23,study7Line,14.0,44,50,1884,47,stackbar,set2,3,3,False,1.6438561897747246,3,2,non-aligned,non-aligned
23,study7Line,14.0,45,33,1885,32,stackbar,set2,1,1,False,0.16992500144231237,7,0,start0,aligned
23,study7Line,16.0,46,33,1886,34,stackbar,set1,-1,1,False,0.16992500144231237,9,0,start0,aligned
23,study7Line,12.0,47,22,1887,22,stackbar,set2,0,0,True,-3.0,3,0,start0,aligned
23,study7Line,13.0,48,46,1888,47,stackbar,set1,-1,1,False,0.16992500144231237,3,0,start0,aligned
23,study7Line,13.0,49,18,1889,20,stackbar,set2,-2,2,False,1.0874628412503393,5,0,start75,aligned
23,study7Line,15.0,50,37,1890,37,stackbar,set1,0,0,True,-3.0,12,0,start0,aligned
23,study7Line,7.0,51,30,1891,29,stackbar,set4,1,1,False,0.16992500144231237,4,0,start0,aligned
23,study7Line,13.0,52,20,1892,22,stackbar,set1,-2,2,False,1.0874628412503393,3,2,non-aligned,non-aligned
23,study7Line,9.0,53,30,1893,31,stackbar,set1,-1,1,False,0.16992500144231237,6,0,start0,aligned
23,study7Line,12.0,54,40,1894,41,stackbar,set2,-1,1,False,0.16992500144231237,9,4,non-aligned,non-aligned
23,study7Line,16.0,55,18,1895,19,stackbar,set4,-1,1,False,0.16992500144231237,6,0,start0,aligned
23,study7Line,18.0,56,53,1896,48,stackbar,set1,5,5,False,2.357552004618084,2,9,non-aligned,non-aligned
23,study7Line,11.0,57,27,1897,26,stackbar,set3,1,1,False,0.16992500144231237,1,0,start0,aligned
23,study7Line,12.0,58,35,1898,39,stackbar,set4,-4,4,False,2.0443941193584534,11,0,start0,aligned
23,study7Line,13.0,59,42,1899,44,stackbar,set3,-2,2,False,1.0874628412503393,6,8,non-aligned,non-aligned
23,study7Line,11.0,60,37,1900,35,stackbar,set3,2,2,False,1.0874628412503393,10,0,start0,aligned
23,study7Line,11.0,61,48,1901,49,stackbar,set4,-1,1,False,0.16992500144231237,1,0,start0,aligned
23,study7Line,9.0,62,45,1902,46,stackbar,set3,-1,1,False,0.16992500144231237,4,0,start0,aligned
23,study7Line,10.0,63,22,1903,21,stackbar,set4,1,1,False,0.16992500144231237,4,0,start0,aligned
23,study7Line,8.0,64,21,1904,23,stackbar,set1,-2,2,False,1.0874628412503393,2,3,non-aligned,non-aligned
23,study7Line,12.0,65,50,1905,43,stackbar,set4,7,7,False,2.8328900141647417,7,6,non-aligned,non-aligned
23,study7Line,13.0,66,15,1906,16,stackbar,set1,-1,1,False,0.16992500144231237,9,0,start0,aligned
23,study7Line,7.0,67,50,1907,46,stackbar,set1,4,4,False,2.0443941193584534,4,6,non-aligned,non-aligned
23,study7Line,13.0,68,40,1908,36,stackbar,set3,4,4,False,2.0443941193584534,11,3,non-aligned,non-aligned
23,study7Line,10.0,69,17,1909,18,stackbar,set3,-1,1,False,0.16992500144231237,7,0,start0,aligned
23,study7Line,21.0,70,40,1910,40,stackbar,set4,0,0,True,-3.0,10,2,non-aligned,non-aligned
23,study7Line,14.0,71,42,1911,43,stackbar,set3,-1,1,False,0.16992500144231237,7,0,start0,aligned
23,study7Line,8.0,72,27,1912,28,stackbar,set1,-1,1,False,0.16992500144231237,3,0,start0,aligned
23,study7Line,9.0,73,25,1913,25,stackbar,set1,0,0,True,-3.0,0,0,start0,aligned
23,study7Line,10.0,74,15,1914,17,stackbar,set1,-2,2,False,1.0874628412503393,8,0,start25,aligned
23,study7Line,14.0,75,30,1915,29,stackbar,set4,1,1,False,0.16992500144231237,4,3,non-aligned,non-aligned
23,study7Line,15.0,76,35,1916,30,stackbar,set2,5,5,False,2.357552004618084,5,4,non-aligned,non-aligned
23,study7Line,8.0,77,50,1917,50,stackbar,set1,0,0,True,-3.0,0,0,start0,aligned
23,study7Line,11.0,78,15,1918,16,stackbar,set3,-1,1,False,0.16992500144231237,9,3,non-aligned,non-aligned
23,study7Line,9.0,79,10,1919,13,stackbar,set2,-3,3,False,1.6438561897747246,12,0,start0,aligned
36,study7Line,16.0,0,50,2880,43,stackbar,set1,7,7,False,2.8328900141647417,7,2,non-aligned,non-aligned
36,study7Line,8.0,1,45,2881,47,stackbar,set4,-2,2,False,1.0874628412503393,3,0,start0,aligned
36,study7Line,13.0,2,10,2882,12,stackbar,set4,-2,2,False,1.0874628412503393,12,0,start0,aligned
36,study7Line,15.0,3,42,2883,41,stackbar,set3,1,1,False,0.16992500144231237,9,0,start0,aligned
36,study7Line,15.0,4,50,2884,47,stackbar,set3,3,3,False,1.6438561897747246,3,10,non-aligned,non-aligned
36,study7Line,13.0,5,25,2885,23,stackbar,set4,2,2,False,1.0874628412503393,2,10,non-aligned,non-aligned
36,study7Line,8.0,6,18,2886,19,stackbar,set3,-1,1,False,0.16992500144231237,6,0,start0,aligned
36,study7Line,7.0,7,30,2887,32,stackbar,set3,-2,2,False,1.0874628412503393,7,0,start0,aligned
36,study7Line,9.0,8,45,2888,35,stackbar,set3,10,10,False,3.3398500028846247,10,2,non-aligned,non-aligned
36,study7Line,8.0,9,20,2889,20,stackbar,set1,0,0,True,-3.0,5,0,start0,aligned
36,study7Line,16.0,10,30,2890,24,stackbar,set3,6,6,False,2.6147098441152083,1,8,non-aligned,non-aligned
36,study7Line,11.0,11,18,2891,18,stackbar,set2,0,0,True,-3.0,7,0,start0,aligned
36,study7Line,14.0,12,13,2892,13,stackbar,set1,0,0,True,-3.0,12,0,start0,aligned
36,study7Line,6.0,13,26,2893,26,stackbar,set2,0,0,True,-3.0,1,0,start0,aligned
36,study7Line,11.0,14,45,2894,42,stackbar,set1,3,3,False,1.6438561897747246,8,0,start0,aligned
36,study7Line,13.0,15,35,2895,40,stackbar,set4,-5,5,False,2.357552004618084,10,2,non-aligned,non-aligned
36,study7Line,9.0,16,10,2896,11,stackbar,set1,-1,1,False,0.16992500144231237,11,4,non-aligned,non-aligned
36,study7Line,17.0,17,35,2897,34,stackbar,set2,1,1,False,0.16992500144231237,9,2,non-aligned,non-aligned
36,study7Line,10.0,18,32,2898,36,stackbar,set3,-4,4,False,2.0443941193584534,11,0,start0,aligned
36,study7Line,12.0,19,40,2899,40,stackbar,set4,0,0,True,-3.0,10,0,start0,aligned
36,study7Line,11.0,20,27,2900,29,stackbar,set1,-2,2,False,1.0874628412503393,4,2,non-aligned,non-aligned
36,study7Line,13.0,21,35,2901,35,stackbar,set4,0,0,True,-3.0,10,0,start0,aligned
36,study7Line,6.0,22,24,2902,24,stackbar,set1,0,0,True,-3.0,1,0,start0,aligned
36,study7Line,12.0,23,50,2903,44,stackbar,set2,6,6,False,2.6147098441152083,6,9,non-aligned,non-aligned
36,study7Line,5.0,24,27,2904,28,stackbar,set1,-1,1,False,0.16992500144231237,3,0,start0,aligned
36,study7Line,20.0,25,15,2905,13,stackbar,set3,2,2,False,1.0874628412503393,12,2,non-aligned,non-aligned
36,study7Line,12.0,26,35,2906,33,stackbar,set1,2,2,False,1.0874628412503393,8,0,start0,aligned
36,study7Line,7.0,27,43,2907,45,stackbar,set3,-2,2,False,1.0874628412503393,5,0,start0,aligned
36,study7Line,11.0,28,37,2908,38,stackbar,set1,-1,1,False,0.16992500144231237,12,0,start0,aligned
36,study7Line,9.0,29,30,2909,31,stackbar,set4,-1,1,False,0.16992500144231237,6,0,end50,aligned
36,study7Line,13.0,30,43,2910,43,stackbar,set1,0,0,True,-3.0,7,0,start0,aligned
36,study7Line,15.0,31,33,2911,34,stackbar,set4,-1,1,False,0.16992500144231237,9,0,start0,aligned
36,study7Line,11.0,32,45,2912,39,stackbar,set3,6,6,False,2.6147098441152083,11,3,non-aligned,non-aligned
36,study7Line,10.0,33,50,2913,49,stackbar,set4,1,1,False,0.16992500144231237,1,5,non-aligned,non-aligned
36,study7Line,9.0,34,25,2914,21,stackbar,set2,4,4,False,2.0443941193584534,4,6,non-aligned,non-aligned
36,study7Line,8.0,35,30,2915,30,stackbar,set2,0,0,True,-3.0,5,0,start0,aligned
36,study7Line,13.0,36,48,2916,46,stackbar,set1,2,2,False,1.0874628412503393,4,6,non-aligned,non-aligned
36,study7Line,10.0,37,47,2917,46,stackbar,set3,1,1,False,0.16992500144231237,4,0,start0,aligned
36,study7Line,6.0,38,49,2918,49,stackbar,set3,0,0,True,-3.0,1,0,start0,aligned
36,study7Line,8.0,39,15,2919,16,stackbar,set3,-1,1,False,0.16992500144231237,9,0,start0,aligned
36,study7Line,9.0,40,28,2920,31,stackbar,set4,-3,3,False,1.6438561897747246,6,0,start0,aligned
36,study7Line,12.0,41,30,2921,33,stackbar,set4,-3,3,False,1.6438561897747246,8,4,non-aligned,non-aligned
36,study7Line,9.0,42,23,2922,23,stackbar,set1,0,0,True,-3.0,2,0,start0,aligned
36,study7Line,9.0,43,50,2923,48,stackbar,set1,2,2,False,1.0874628412503393,2,9,non-aligned,non-aligned
36,study7Line,16.0,44,23,2924,22,stackbar,set3,1,1,False,0.16992500144231237,3,2,non-aligned,non-aligned
36,study7Line,8.0,45,15,2925,15,stackbar,set4,0,0,True,-3.0,10,0,start0,aligned
36,study7Line,11.0,46,15,2926,15,stackbar,set4,0,0,True,-3.0,10,4,non-aligned,non-aligned
36,study7Line,9.0,47,35,2927,37,stackbar,set2,-2,2,False,1.0874628412503393,12,0,start0,aligned
36,study7Line,16.0,48,40,2928,38,stackbar,set1,2,2,False,1.0874628412503393,12,1,non-aligned,non-aligned
36,study7Line,6.0,49,10,2929,12,stackbar,set4,-2,2,False,1.0874628412503393,12,6,non-aligned,non-aligned
36,study7Line,10.0,50,17,2930,17,stackbar,set2,0,0,True,-3.0,8,0,start0,aligned
36,study7Line,6.0,51,45,2931,44,stackbar,set2,1,1,False,0.16992500144231237,6,0,start0,aligned
36,study7Line,4.0,52,28,2932,29,stackbar,set2,-1,1,False,0.16992500144231237,4,0,start0,aligned
36,study7Line,6.0,53,25,2933,25,stackbar,set3,0,0,True,-3.0,0,5,non-aligned,non-aligned
36,study7Line,14.0,54,40,2934,41,stackbar,set3,-1,1,False,0.16992500144231237,9,1,non-aligned,non-aligned
36,study7Line,9.0,55,15,2935,14,stackbar,set3,1,1,False,0.16992500144231237,11,2,non-aligned,non-aligned
36,study7Line,8.0,56,35,2936,39,stackbar,set4,-4,4,False,2.0443941193584534,11,0,start0,aligned
36,study7Line,6.0,57,47,2937,48,stackbar,set3,-1,1,False,0.16992500144231237,2,0,start0,aligned
36,study7Line,16.0,58,42,2938,42,stackbar,set4,0,0,True,-3.0,8,1,non-aligned,non-aligned
36,study7Line,18.0,59,22,2939,22,stackbar,set3,0,0,True,-3.0,3,0,start0,aligned
36,study7Line,9.0,60,30,2940,32,stackbar,set1,-2,2,False,1.0874628412503393,7,2,non-aligned,non-aligned
36,study7Line,10.0,61,25,2941,26,stackbar,set2,-1,1,False,0.16992500144231237,1,10,non-aligned,non-aligned
36,study7Line,5.0,62,50,2942,50,stackbar,set1,0,0,True,-3.0,0,0,start0,aligned
36,study7Line,6.0,63,22,2943,21,stackbar,set3,1,1,False,0.16992500144231237,4,0,start0,aligned
36,study7Line,7.0,64,28,2944,28,stackbar,set2,0,0,True,-3.0,3,8,non-aligned,non-aligned
36,study7Line,10.0,65,20,2945,20,stackbar,set1,0,0,True,-3.0,5,0,start75,aligned
36,study7Line,13.0,66,42,2946,45,stackbar,set1,-3,3,False,1.6438561897747246,5,2,non-aligned,non-aligned
36,study7Line,4.0,67,27,2947,27,stackbar,set2,0,0,True,-3.0,2,0,start0,aligned
36,study7Line,4.0,68,25,2948,25,stackbar,set2,0,0,True,-3.0,0,0,start0,aligned
36,study7Line,8.0,69,27,2949,27,stackbar,set3,0,0,True,-3.0,2,6,non-aligned,non-aligned
36,study7Line,7.0,70,15,2950,16,stackbar,set2,-1,1,False,0.16992500144231237,9,2,non-aligned,non-aligned
36,study7Line,7.0,71,50,2951,50,stackbar,set1,0,0,True,-3.0,0,6,non-aligned,non-aligned
36,study7Line,16.0,72,33,2952,36,stackbar,set4,-3,3,False,1.6438561897747246,11,3,non-aligned,non-aligned
36,study7Line,16.0,73,22,2953,30,stackbar,set1,-8,8,False,3.0223678130284544,5,8,non-aligned,non-aligned
36,study7Line,11.0,74,20,2954,19,stackbar,set1,1,1,False,0.16992500144231237,6,8,non-aligned,non-aligned
36,study7Line,7.0,75,18,2955,18,stackbar,set3,0,0,True,-3.0,7,2,non-aligned,non-aligned
36,study7Line,7.0,76,13,2956,14,stackbar,set4,-1,1,False,0.16992500144231237,11,0,start0,aligned
36,study7Line,12.0,77,33,2957,37,stackbar,set3,-4,4,False,2.0443941193584534,12,0,start25,aligned
36,study7Line,13.0,78,13,2958,17,stackbar,set4,-4,4,False,2.0443941193584534,8,1,non-aligned,non-aligned
36,study7Line,6.0,79,10,2959,11,stackbar,set2,-1,1,False,0.16992500144231237,11,0,start0,aligned
5,study7Line,13.0,0,18,400,15,stackbar,set1,3,3,False,1.6438561897747246,10,0,start0,aligned
5,study7Line,12.0,1,20,401,22,stackbar,set2,-2,2,False,1.0874628412503393,3,0,start0,aligned
5,study7Line,13.0,2,47,402,47,stackbar,set3,0,0,True,-3.0,3,10,non-aligned,non-aligned
5,study7Line,15.0,3,19,403,13,stackbar,set3,6,6,False,2.6147098441152083,12,2,non-aligned,non-aligned
5,study7Line,12.0,4,40,404,40,stackbar,set1,0,0,True,-3.0,10,0,start0,aligned
5,study7Line,10.0,5,50,405,50,stackbar,set2,0,0,True,-3.0,0,0,start0,aligned
5,study7Line,9.0,6,40,406,36,stackbar,set2,4,4,False,2.0443941193584534,11,1,non-aligned,non-aligned
5,study7Line,28.0,7,40,407,42,stackbar,set4,-2,2,False,1.0874628412503393,8,0,start0,aligned
5,study7Line,12.0,8,40,408,39,stackbar,set3,1,1,False,0.16992500144231237,11,0,start0,aligned
5,study7Line,9.0,9,19,409,20,stackbar,set1,-1,1,False,0.16992500144231237,5,0,start75,aligned
5,study7Line,10.0,10,28,410,30,stackbar,set2,-2,2,False,1.0874628412503393,5,4,non-aligned,non-aligned
5,study7Line,9.0,11,13,411,11,stackbar,set4,2,2,False,1.0874628412503393,11,4,non-aligned,non-aligned
5,study7Line,8.0,12,48,412,49,stackbar,set1,-1,1,False,0.16992500144231237,1,0,start0,aligned
5,study7Line,7.0,13,30,413,31,stackbar,set2,-1,1,False,0.16992500144231237,6,0,start0,aligned
5,study7Line,7.0,14,13,414,13,stackbar,set4,0,0,True,-3.0,12,0,start0,aligned
5,study7Line,13.0,15,33,415,38,stackbar,set3,-5,5,False,2.357552004618084,12,3,non-aligned,non-aligned
5,study7Line,10.0,16,12,416,12,stackbar,set4,0,0,True,-3.0,12,6,non-aligned,non-aligned
5,study7Line,7.0,17,31,417,32,stackbar,set2,-1,1,False,0.16992500144231237,7,0,start0,aligned
5,study7Line,8.0,18,32,418,33,stackbar,set4,-1,1,False,0.16992500144231237,8,0,start0,aligned
5,study7Line,11.0,19,38,419,40,stackbar,set2,-2,2,False,1.0874628412503393,10,1,non-aligned,non-aligned
5,study7Line,14.0,20,50,420,49,stackbar,set2,1,1,False,0.16992500144231237,1,8,non-aligned,non-aligned
5,study7Line,17.0,21,32,421,35,stackbar,set2,-3,3,False,1.6438561897747246,10,0,start0,aligned
5,study7Line,8.0,22,21,422,20,stackbar,set1,1,1,False,0.16992500144231237,5,0,start0,aligned
5,study7Line,8.0,23,27,423,28,stackbar,set1,-1,1,False,0.16992500144231237,3,0,start0,aligned
5,study7Line,21.0,24,45,424,44,stackbar,set2,1,1,False,0.16992500144231237,6,9,non-aligned,non-aligned
5,study7Line,7.0,25,13,425,12,stackbar,set3,1,1,False,0.16992500144231237,12,0,start0,aligned
5,study7Line,12.0,26,47,426,48,stackbar,set2,-1,1,False,0.16992500144231237,2,0,start0,aligned
5,study7Line,15.0,27,38,427,38,stackbar,set4,0,0,True,-3.0,12,0,start0,aligned
5,study7Line,9.0,28,25,428,31,stackbar,set1,-6,6,False,2.6147098441152083,6,4,non-aligned,non-aligned
5,study7Line,7.0,29,23,429,24,stackbar,set2,-1,1,False,0.16992500144231237,1,0,start0,aligned
5,study7Line,13.0,30,38,430,41,stackbar,set3,-3,3,False,1.6438561897747246,9,1,non-aligned,non-aligned
5,study7Line,15.0,31,15,431,15,stackbar,set4,0,0,True,-3.0,10,4,non-aligned,non-aligned
5,study7Line,9.0,32,36,432,37,stackbar,set4,-1,1,False,0.16992500144231237,12,1,non-aligned,non-aligned
5,study7Line,12.0,33,50,433,50,stackbar,set4,0,0,True,-3.0,0,7,non-aligned,non-aligned
5,study7Line,13.0,34,28,434,22,stackbar,set2,6,6,False,2.6147098441152083,3,9,non-aligned,non-aligned
5,study7Line,9.0,35,52,435,48,stackbar,set1,4,4,False,2.0443941193584534,2,9,non-aligned,non-aligned
5,study7Line,12.0,36,51,436,43,stackbar,set4,8,8,False,3.0223678130284544,7,6,non-aligned,non-aligned
5,study7Line,16.0,37,38,437,39,stackbar,set2,-1,1,False,0.16992500144231237,11,1,non-aligned,non-aligned
5,study7Line,9.0,38,45,438,44,stackbar,set3,1,1,False,0.16992500144231237,6,0,start0,aligned
5,study7Line,6.0,39,25,439,25,stackbar,set3,0,0,True,-3.0,0,0,start0,aligned
5,study7Line,13.0,40,26,440,32,stackbar,set4,-6,6,False,2.6147098441152083,7,7,non-aligned,non-aligned
5,study7Line,10.0,41,46,441,46,stackbar,set4,0,0,True,-3.0,4,0,start0,aligned
5,study7Line,7.0,42,20,442,21,stackbar,set4,-1,1,False,0.16992500144231237,4,2,non-aligned,non-aligned
5,study7Line,8.0,43,13,443,16,stackbar,set1,-3,3,False,1.6438561897747246,9,1,non-aligned,non-aligned
5,study7Line,11.0,44,42,444,35,stackbar,set2,7,7,False,2.8328900141647417,10,3,non-aligned,non-aligned
5,study7Line,9.0,45,20,445,19,stackbar,set1,1,1,False,0.16992500144231237,6,8,non-aligned,non-aligned
5,study7Line,8.0,46,54,446,46,stackbar,set2,8,8,False,3.0223678130284544,4,9,non-aligned,non-aligned
5,study7Line,8.0,47,50,447,45,stackbar,set4,5,5,False,2.357552004618084,5,7,non-aligned,non-aligned
5,study7Line,7.0,48,33,448,36,stackbar,set3,-3,3,False,1.6438561897747246,11,0,start0,aligned
5,study7Line,10.0,49,27,449,29,stackbar,set3,-2,2,False,1.0874628412503393,4,9,non-aligned,non-aligned
5,study7Line,9.0,50,23,450,24,stackbar,set1,-1,1,False,0.16992500144231237,1,5,non-aligned,non-aligned
5,study7Line,7.0,51,27,451,26,stackbar,set2,1,1,False,0.16992500144231237,1,0,start0,aligned
5,study7Line,7.0,52,45,452,42,stackbar,set2,3,3,False,1.6438561897747246,8,4,non-aligned,non-aligned
5,study7Line,9.0,53,27,453,28,stackbar,set4,-1,1,False,0.16992500144231237,3,5,non-aligned,non-aligned
5,study7Line,7.0,54,27,454,27,stackbar,set2,0,0,True,-3.0,2,0,start0,aligned
5,study7Line,12.0,55,16,455,18,stackbar,set1,-2,2,False,1.0874628412503393,7,1,non-aligned,non-aligned
5,study7Line,7.0,56,32,456,34,stackbar,set3,-2,2,False,1.0874628412503393,9,0,start0,aligned
5,study7Line,9.0,57,23,457,23,stackbar,set3,0,0,True,-3.0,2,0,start0,aligned
5,study7Line,7.0,58,21,458,21,stackbar,set4,0,0,True,-3.0,4,0,start0,aligned
5,study7Line,9.0,59,17,459,17,stackbar,set1,0,0,True,-3.0,8,0,start0,aligned
5,study7Line,10.0,60,11,460,14,stackbar,set4,-3,3,False,1.6438561897747246,11,0,start0,aligned
5,study7Line,11.0,61,28,461,29,stackbar,set3,-1,1,False,0.16992500144231237,4,0,start0,aligned
5,study7Line,9.0,62,43,462,43,stackbar,set4,0,0,True,-3.0,7,0,start0,aligned
5,study7Line,7.0,63,29,463,30,stackbar,set2,-1,1,False,0.16992500144231237,5,0,start0,aligned
5,study7Line,7.0,64,21,464,19,stackbar,set3,2,2,False,1.0874628412503393,6,0,start0,aligned
5,study7Line,6.0,65,25,465,25,stackbar,set3,0,0,True,-3.0,0,5,non-aligned,non-aligned
5,study7Line,15.0,66,30,466,33,stackbar,set2,-3,3,False,1.6438561897747246,8,8,non-aligned,non-aligned
5,study7Line,11.0,67,44,467,41,stackbar,set4,3,3,False,1.6438561897747246,9,0,start0,aligned
5,study7Line,10.0,68,11,468,14,stackbar,set1,-3,3,False,1.6438561897747246,11,5,non-aligned,non-aligned
5,study7Line,7.0,69,18,469,18,stackbar,set1,0,0,True,-3.0,7,0,start0,aligned
5,study7Line,18.0,70,36,470,37,stackbar,set4,-1,1,False,0.16992500144231237,12,0,start0,aligned
5,study7Line,8.0,71,8,471,11,stackbar,set4,-3,3,False,1.6438561897747246,11,0,start0,aligned
5,study7Line,15.0,72,32,472,34,stackbar,set4,-2,2,False,1.0874628412503393,9,2,non-aligned,non-aligned
5,study7Line,7.0,73,46,473,47,stackbar,set1,-1,1,False,0.16992500144231237,3,0,start0,aligned
5,study7Line,10.0,74,28,474,27,stackbar,set4,1,1,False,0.16992500144231237,2,3,non-aligned,non-aligned
5,study7Line,9.0,75,18,475,16,stackbar,set3,2,2,False,1.0874628412503393,9,0,start0,aligned
5,study7Line,9.0,76,45,476,45,stackbar,set2,0,0,True,-3.0,5,0,start0,aligned
5,study7Line,8.0,77,17,477,17,stackbar,set2,0,0,True,-3.0,8,5,non-aligned,non-aligned
5,study7Line,8.0,78,22,478,26,stackbar,set4,-4,4,False,2.0443941193584534,1,1,non-aligned,non-aligned
5,study7Line,11.0,79,23,479,23,stackbar,set3,0,0,True,-3.0,2,10,non-aligned,non-aligned
